id,station_id,update,nbBikes,nbEmptyDocks,capacity
1,3,2011-08-22 16:23:33.557-04,12,5,17
2,5,2011-08-22 16:23:33.557-04,4,11,15
3,6,2011-08-22 16:23:33.557-04,8,7,15
4,8,2011-08-22 16:23:33.557-04,2,13,15
5,9,2011-08-22 16:23:33.557-04,6,13,19
6,10,2011-08-22 16:23:33.557-04,6,13,19
7,11,2011-08-22 16:23:33.557-04,9,6,15
8,12,2011-08-22 16:23:33.557-04,5,10,15
9,13,2011-08-22 16:23:33.557-04,4,11,15
10,14,2011-08-22 16:23:33.557-04,6,11,17
11,15,2011-08-22 16:23:33.557-04,2,13,15
12,16,2011-08-22 16:23:33.557-04,12,7,19
13,17,2011-08-22 16:23:33.557-04,11,4,15
14,18,2011-08-22 16:23:33.557-04,5,10,15
15,20,2011-08-22 16:23:33.557-04,13,6,19
16,21,2011-08-22 16:23:33.557-04,6,17,23
17,22,2011-08-22 16:23:33.557-04,22,25,47
18,23,2011-08-22 16:23:33.557-04,16,2,18
19,24,2011-08-22 16:23:33.557-04,10,5,15
20,25,2011-08-22 16:23:33.557-04,6,9,15
21,26,2011-08-22 16:23:33.557-04,8,7,15
22,27,2011-08-22 16:23:33.557-04,5,9,14
23,30,2011-08-22 16:23:33.557-04,5,10,15
24,31,2011-08-22 16:23:33.557-04,6,5,11
25,32,2011-08-22 16:23:33.557-04,6,5,11
26,33,2011-08-22 16:23:33.557-04,8,11,19
27,34,2011-08-22 16:23:33.557-04,9,6,15
28,35,2011-08-22 16:23:33.557-04,0,11,11
29,36,2011-08-22 16:23:33.557-04,7,9,16
30,37,2011-08-22 16:23:33.557-04,8,7,15
31,38,2011-08-22 16:23:33.557-04,15,20,35
32,39,2011-08-22 16:23:33.557-04,6,13,19
33,40,2011-08-22 16:23:33.557-04,4,9,13
34,41,2011-08-22 16:23:33.557-04,11,8,19
35,42,2011-08-22 16:23:33.557-04,10,9,19
36,43,2011-08-22 16:23:33.557-04,7,8,15
37,44,2011-08-22 16:23:33.557-04,18,1,19
38,45,2011-08-22 16:23:33.557-04,11,8,19
39,46,2011-08-22 16:23:33.557-04,11,8,19
40,47,2011-08-22 16:23:33.557-04,9,2,11
41,48,2011-08-22 16:23:33.557-04,7,8,15
42,49,2011-08-22 16:23:33.557-04,4,11,15
43,50,2011-08-22 16:23:33.557-04,1,14,15
44,51,2011-08-22 16:23:33.557-04,7,8,15
45,52,2011-08-22 16:23:33.557-04,5,9,14
46,53,2011-08-22 16:23:33.557-04,7,8,15
47,55,2011-08-22 16:23:33.557-04,4,11,15
48,56,2011-08-22 16:23:33.557-04,4,11,15
49,57,2011-08-22 16:23:33.557-04,9,2,11
50,3,2011-08-22 16:44:57.201-04,12,5,17
51,5,2011-08-22 16:44:57.201-04,4,11,15
52,6,2011-08-22 16:44:57.201-04,8,7,15
53,8,2011-08-22 16:44:57.201-04,2,13,15
54,9,2011-08-22 16:44:57.201-04,8,11,19
55,10,2011-08-22 16:44:57.201-04,5,14,19
56,11,2011-08-22 16:44:57.201-04,6,9,15
57,12,2011-08-22 16:44:57.201-04,5,10,15
58,13,2011-08-22 16:44:57.201-04,2,13,15
59,14,2011-08-22 16:44:57.201-04,4,13,17
60,15,2011-08-22 16:44:57.201-04,3,12,15
61,16,2011-08-22 16:44:57.201-04,12,7,19
62,17,2011-08-22 16:44:57.201-04,6,9,15
63,18,2011-08-22 16:44:57.201-04,5,10,15
64,20,2011-08-22 16:44:57.201-04,15,4,19
65,21,2011-08-22 16:44:57.201-04,9,14,23
66,22,2011-08-22 16:44:57.201-04,23,24,47
67,23,2011-08-22 16:44:57.201-04,14,4,18
68,24,2011-08-22 16:44:57.201-04,12,3,15
69,25,2011-08-22 16:44:57.201-04,3,12,15
70,26,2011-08-22 16:44:57.201-04,8,7,15
71,27,2011-08-22 16:44:57.201-04,5,9,14
72,30,2011-08-22 16:44:57.201-04,5,10,15
73,31,2011-08-22 16:44:57.201-04,6,5,11
74,32,2011-08-22 16:44:57.201-04,5,6,11
75,33,2011-08-22 16:44:57.201-04,7,12,19
76,34,2011-08-22 16:44:57.201-04,10,5,15
77,35,2011-08-22 16:44:57.201-04,0,11,11
78,36,2011-08-22 16:44:57.201-04,3,13,16
79,37,2011-08-22 16:44:57.201-04,8,7,15
80,38,2011-08-22 16:44:57.201-04,18,17,35
81,39,2011-08-22 16:44:57.201-04,10,9,19
82,40,2011-08-22 16:44:57.201-04,9,4,13
83,41,2011-08-22 16:44:57.201-04,5,14,19
84,42,2011-08-22 16:44:57.201-04,8,11,19
85,43,2011-08-22 16:44:57.201-04,6,9,15
86,44,2011-08-22 16:44:57.201-04,18,1,19
87,45,2011-08-22 16:44:57.201-04,11,8,19
88,46,2011-08-22 16:44:57.201-04,10,9,19
89,47,2011-08-22 16:44:57.201-04,8,3,11
90,48,2011-08-22 16:44:57.201-04,4,11,15
91,49,2011-08-22 16:44:57.201-04,0,15,15
92,50,2011-08-22 16:44:57.201-04,0,15,15
93,51,2011-08-22 16:44:57.201-04,7,8,15
94,52,2011-08-22 16:44:57.201-04,8,6,14
95,53,2011-08-22 16:44:57.201-04,9,6,15
96,55,2011-08-22 16:44:57.201-04,1,14,15
97,56,2011-08-22 16:44:57.201-04,4,11,15
98,57,2011-08-22 16:44:57.201-04,7,4,11
99,3,2011-08-22 16:45:58.076-04,12,5,17
100,5,2011-08-22 16:45:58.076-04,4,11,15
101,6,2011-08-22 16:45:58.076-04,8,7,15
102,8,2011-08-22 16:45:58.076-04,2,13,15
103,9,2011-08-22 16:45:58.076-04,8,11,19
104,10,2011-08-22 16:45:58.076-04,5,14,19
105,11,2011-08-22 16:45:58.076-04,6,9,15
106,12,2011-08-22 16:45:58.076-04,5,10,15
107,13,2011-08-22 16:45:58.076-04,2,13,15
108,14,2011-08-22 16:45:58.076-04,4,13,17
109,15,2011-08-22 16:45:58.076-04,3,12,15
110,16,2011-08-22 16:45:58.076-04,12,7,19
111,17,2011-08-22 16:45:58.076-04,6,9,15
112,18,2011-08-22 16:45:58.076-04,5,10,15
113,20,2011-08-22 16:45:58.076-04,15,4,19
114,21,2011-08-22 16:45:58.076-04,9,14,23
115,22,2011-08-22 16:45:58.076-04,23,24,47
116,23,2011-08-22 16:45:58.076-04,14,4,18
117,24,2011-08-22 16:45:58.076-04,12,3,15
118,25,2011-08-22 16:45:58.076-04,3,12,15
119,26,2011-08-22 16:45:58.076-04,8,7,15
120,27,2011-08-22 16:45:58.076-04,5,9,14
121,30,2011-08-22 16:45:58.076-04,5,10,15
122,31,2011-08-22 16:45:58.076-04,6,5,11
123,32,2011-08-22 16:45:58.076-04,5,6,11
124,33,2011-08-22 16:45:58.076-04,7,12,19
125,34,2011-08-22 16:45:58.076-04,10,5,15
126,35,2011-08-22 16:45:58.076-04,0,11,11
127,36,2011-08-22 16:45:58.076-04,2,14,16
128,37,2011-08-22 16:45:58.076-04,8,7,15
129,38,2011-08-22 16:45:58.076-04,18,17,35
130,39,2011-08-22 16:45:58.076-04,10,9,19
131,40,2011-08-22 16:45:58.076-04,9,4,13
132,41,2011-08-22 16:45:58.076-04,5,14,19
133,42,2011-08-22 16:45:58.076-04,8,11,19
134,43,2011-08-22 16:45:58.076-04,6,9,15
135,44,2011-08-22 16:45:58.076-04,18,1,19
136,45,2011-08-22 16:45:58.076-04,11,8,19
137,46,2011-08-22 16:45:58.076-04,10,9,19
138,47,2011-08-22 16:45:58.076-04,8,3,11
139,48,2011-08-22 16:45:58.076-04,3,12,15
140,49,2011-08-22 16:45:58.076-04,0,15,15
141,50,2011-08-22 16:45:58.076-04,0,15,15
142,51,2011-08-22 16:45:58.076-04,7,8,15
143,52,2011-08-22 16:45:58.076-04,8,6,14
144,53,2011-08-22 16:45:58.076-04,9,6,15
145,55,2011-08-22 16:45:58.076-04,1,14,15
146,56,2011-08-22 16:45:58.076-04,4,11,15
147,57,2011-08-22 16:45:58.076-04,7,4,11
148,3,2011-08-22 16:46:58.87-04,12,5,17
149,5,2011-08-22 16:46:58.87-04,4,11,15
150,6,2011-08-22 16:46:58.87-04,8,7,15
151,8,2011-08-22 16:46:58.87-04,2,13,15
152,9,2011-08-22 16:46:58.87-04,8,11,19
153,10,2011-08-22 16:46:58.87-04,5,14,19
154,11,2011-08-22 16:46:58.87-04,6,9,15
155,12,2011-08-22 16:46:58.87-04,5,10,15
156,13,2011-08-22 16:46:58.87-04,2,13,15
157,14,2011-08-22 16:46:58.87-04,4,13,17
158,15,2011-08-22 16:46:58.87-04,3,12,15
159,16,2011-08-22 16:46:58.87-04,12,7,19
160,17,2011-08-22 16:46:58.87-04,6,9,15
161,18,2011-08-22 16:46:58.87-04,5,10,15
162,20,2011-08-22 16:46:58.87-04,15,4,19
163,21,2011-08-22 16:46:58.87-04,9,14,23
164,22,2011-08-22 16:46:58.87-04,23,24,47
165,23,2011-08-22 16:46:58.87-04,13,5,18
166,24,2011-08-22 16:46:58.87-04,14,1,15
167,25,2011-08-22 16:46:58.87-04,3,12,15
168,26,2011-08-22 16:46:58.87-04,8,7,15
169,27,2011-08-22 16:46:58.87-04,5,9,14
170,30,2011-08-22 16:46:58.87-04,5,10,15
171,31,2011-08-22 16:46:58.87-04,6,5,11
172,32,2011-08-22 16:46:58.87-04,5,6,11
173,33,2011-08-22 16:46:58.87-04,7,12,19
174,34,2011-08-22 16:46:58.87-04,10,5,15
175,35,2011-08-22 16:46:58.87-04,0,11,11
176,36,2011-08-22 16:46:58.87-04,2,14,16
177,37,2011-08-22 16:46:58.87-04,8,7,15
178,38,2011-08-22 16:46:58.87-04,18,17,35
179,39,2011-08-22 16:46:58.87-04,10,9,19
180,40,2011-08-22 16:46:58.87-04,9,4,13
181,41,2011-08-22 16:46:58.87-04,5,14,19
182,42,2011-08-22 16:46:58.87-04,8,11,19
183,43,2011-08-22 16:46:58.87-04,6,9,15
184,44,2011-08-22 16:46:58.87-04,18,1,19
185,45,2011-08-22 16:46:58.87-04,11,8,19
186,46,2011-08-22 16:46:58.87-04,10,9,19
187,47,2011-08-22 16:46:58.87-04,8,3,11
188,48,2011-08-22 16:46:58.87-04,3,12,15
189,49,2011-08-22 16:46:58.87-04,1,14,15
190,50,2011-08-22 16:46:58.87-04,0,15,15
191,51,2011-08-22 16:46:58.87-04,7,8,15
192,52,2011-08-22 16:46:58.87-04,8,6,14
193,53,2011-08-22 16:46:58.87-04,9,6,15
194,55,2011-08-22 16:46:58.87-04,1,14,15
195,56,2011-08-22 16:46:58.87-04,4,11,15
196,57,2011-08-22 16:46:58.87-04,7,4,11
197,3,2011-08-22 16:47:59.709-04,12,5,17
198,5,2011-08-22 16:47:59.709-04,4,11,15
199,6,2011-08-22 16:47:59.709-04,7,8,15
200,8,2011-08-22 16:47:59.709-04,2,13,15
201,9,2011-08-22 16:47:59.709-04,8,11,19
202,10,2011-08-22 16:47:59.709-04,5,14,19
203,11,2011-08-22 16:47:59.709-04,6,9,15
204,12,2011-08-22 16:47:59.709-04,5,10,15
205,13,2011-08-22 16:47:59.709-04,1,14,15
206,14,2011-08-22 16:47:59.709-04,4,13,17
207,15,2011-08-22 16:47:59.709-04,3,12,15
208,16,2011-08-22 16:47:59.709-04,12,7,19
209,17,2011-08-22 16:47:59.709-04,6,9,15
210,18,2011-08-22 16:47:59.709-04,5,10,15
211,20,2011-08-22 16:47:59.709-04,15,4,19
212,21,2011-08-22 16:47:59.709-04,10,13,23
213,22,2011-08-22 16:47:59.709-04,23,24,47
214,23,2011-08-22 16:47:59.709-04,13,5,18
215,24,2011-08-22 16:47:59.709-04,14,1,15
216,25,2011-08-22 16:47:59.709-04,3,12,15
217,26,2011-08-22 16:47:59.709-04,7,8,15
218,27,2011-08-22 16:47:59.709-04,5,9,14
219,30,2011-08-22 16:47:59.709-04,5,10,15
220,31,2011-08-22 16:47:59.709-04,6,5,11
221,32,2011-08-22 16:47:59.709-04,5,6,11
222,33,2011-08-22 16:47:59.709-04,7,12,19
223,34,2011-08-22 16:47:59.709-04,10,5,15
224,35,2011-08-22 16:47:59.709-04,0,11,11
225,36,2011-08-22 16:47:59.709-04,2,14,16
226,37,2011-08-22 16:47:59.709-04,8,7,15
227,38,2011-08-22 16:47:59.709-04,18,17,35
228,39,2011-08-22 16:47:59.709-04,10,9,19
229,40,2011-08-22 16:47:59.709-04,9,4,13
230,41,2011-08-22 16:47:59.709-04,5,14,19
231,42,2011-08-22 16:47:59.709-04,8,11,19
232,43,2011-08-22 16:47:59.709-04,6,9,15
233,44,2011-08-22 16:47:59.709-04,18,1,19
234,45,2011-08-22 16:47:59.709-04,11,8,19
235,46,2011-08-22 16:47:59.709-04,10,9,19
236,47,2011-08-22 16:47:59.709-04,8,3,11
237,48,2011-08-22 16:47:59.709-04,3,12,15
238,49,2011-08-22 16:47:59.709-04,1,14,15
239,50,2011-08-22 16:47:59.709-04,0,15,15
240,51,2011-08-22 16:47:59.709-04,7,8,15
241,52,2011-08-22 16:47:59.709-04,8,6,14
242,53,2011-08-22 16:47:59.709-04,9,6,15
243,55,2011-08-22 16:47:59.709-04,1,14,15
244,56,2011-08-22 16:47:59.709-04,4,11,15
245,57,2011-08-22 16:47:59.709-04,7,4,11
246,3,2011-08-22 16:49:00.655-04,12,5,17
247,5,2011-08-22 16:49:00.655-04,4,11,15
248,6,2011-08-22 16:49:00.655-04,7,8,15
249,8,2011-08-22 16:49:00.655-04,2,13,15
250,9,2011-08-22 16:49:00.655-04,8,11,19
251,10,2011-08-22 16:49:00.655-04,5,14,19
252,11,2011-08-22 16:49:00.655-04,6,9,15
253,12,2011-08-22 16:49:00.655-04,5,10,15
254,13,2011-08-22 16:49:00.655-04,1,14,15
255,14,2011-08-22 16:49:00.655-04,4,13,17
256,15,2011-08-22 16:49:00.655-04,3,12,15
257,16,2011-08-22 16:49:00.655-04,12,7,19
258,17,2011-08-22 16:49:00.655-04,6,9,15
259,18,2011-08-22 16:49:00.655-04,5,10,15
260,20,2011-08-22 16:49:00.655-04,15,4,19
261,21,2011-08-22 16:49:00.655-04,10,13,23
262,22,2011-08-22 16:49:00.655-04,23,24,47
263,23,2011-08-22 16:49:00.655-04,13,5,18
264,24,2011-08-22 16:49:00.655-04,14,1,15
265,25,2011-08-22 16:49:00.655-04,3,12,15
266,26,2011-08-22 16:49:00.655-04,7,8,15
267,27,2011-08-22 16:49:00.655-04,5,9,14
268,30,2011-08-22 16:49:00.655-04,5,10,15
269,31,2011-08-22 16:49:00.655-04,6,5,11
270,32,2011-08-22 16:49:00.655-04,5,6,11
271,33,2011-08-22 16:49:00.655-04,7,12,19
272,34,2011-08-22 16:49:00.655-04,10,5,15
273,35,2011-08-22 16:49:00.655-04,0,11,11
274,36,2011-08-22 16:49:00.655-04,0,16,16
275,37,2011-08-22 16:49:00.655-04,8,7,15
276,38,2011-08-22 16:49:00.655-04,18,17,35
277,39,2011-08-22 16:49:00.655-04,10,9,19
278,40,2011-08-22 16:49:00.655-04,9,4,13
279,41,2011-08-22 16:49:00.655-04,5,14,19
280,42,2011-08-22 16:49:00.655-04,8,11,19
281,43,2011-08-22 16:49:00.655-04,6,9,15
282,44,2011-08-22 16:49:00.655-04,18,1,19
283,45,2011-08-22 16:49:00.655-04,11,8,19
284,46,2011-08-22 16:49:00.655-04,10,9,19
285,47,2011-08-22 16:49:00.655-04,8,3,11
286,48,2011-08-22 16:49:00.655-04,3,12,15
287,49,2011-08-22 16:49:00.655-04,1,14,15
288,50,2011-08-22 16:49:00.655-04,0,15,15
289,51,2011-08-22 16:49:00.655-04,7,8,15
290,52,2011-08-22 16:49:00.655-04,8,6,14
291,53,2011-08-22 16:49:00.655-04,9,6,15
292,55,2011-08-22 16:49:00.655-04,1,14,15
293,56,2011-08-22 16:49:00.655-04,4,11,15
294,57,2011-08-22 16:49:00.655-04,7,4,11
295,3,2011-08-22 16:50:01.677-04,12,5,17
296,5,2011-08-22 16:50:01.677-04,4,11,15
297,6,2011-08-22 16:50:01.677-04,7,8,15
298,8,2011-08-22 16:50:01.677-04,2,13,15
299,9,2011-08-22 16:50:01.677-04,8,11,19
300,10,2011-08-22 16:50:01.677-04,5,14,19
301,11,2011-08-22 16:50:01.677-04,6,9,15
302,12,2011-08-22 16:50:01.677-04,5,10,15
303,13,2011-08-22 16:50:01.677-04,1,14,15
304,14,2011-08-22 16:50:01.677-04,4,13,17
305,15,2011-08-22 16:50:01.677-04,3,12,15
306,16,2011-08-22 16:50:01.677-04,12,7,19
307,17,2011-08-22 16:50:01.677-04,6,9,15
308,18,2011-08-22 16:50:01.677-04,5,10,15
309,20,2011-08-22 16:50:01.677-04,15,4,19
310,21,2011-08-22 16:50:01.677-04,9,14,23
311,22,2011-08-22 16:50:01.677-04,23,24,47
312,23,2011-08-22 16:50:01.677-04,13,5,18
313,24,2011-08-22 16:50:01.677-04,14,1,15
314,25,2011-08-22 16:50:01.677-04,3,12,15
315,26,2011-08-22 16:50:01.677-04,7,8,15
316,27,2011-08-22 16:50:01.677-04,5,9,14
317,30,2011-08-22 16:50:01.677-04,5,10,15
318,31,2011-08-22 16:50:01.677-04,6,5,11
319,32,2011-08-22 16:50:01.677-04,5,6,11
320,33,2011-08-22 16:50:01.677-04,7,12,19
321,34,2011-08-22 16:50:01.677-04,10,5,15
322,35,2011-08-22 16:50:01.677-04,0,11,11
323,36,2011-08-22 16:50:01.677-04,0,16,16
324,37,2011-08-22 16:50:01.677-04,8,7,15
325,38,2011-08-22 16:50:01.677-04,18,17,35
326,39,2011-08-22 16:50:01.677-04,10,9,19
327,40,2011-08-22 16:50:01.677-04,9,4,13
328,41,2011-08-22 16:50:01.677-04,5,14,19
329,42,2011-08-22 16:50:01.677-04,8,11,19
330,43,2011-08-22 16:50:01.677-04,6,9,15
331,44,2011-08-22 16:50:01.677-04,18,1,19
332,45,2011-08-22 16:50:01.677-04,11,8,19
333,46,2011-08-22 16:50:01.677-04,11,8,19
334,47,2011-08-22 16:50:01.677-04,8,3,11
335,48,2011-08-22 16:50:01.677-04,3,12,15
336,49,2011-08-22 16:50:01.677-04,1,14,15
337,50,2011-08-22 16:50:01.677-04,0,15,15
338,51,2011-08-22 16:50:01.677-04,7,8,15
339,52,2011-08-22 16:50:01.677-04,8,6,14
340,53,2011-08-22 16:50:01.677-04,9,6,15
341,55,2011-08-22 16:50:01.677-04,1,14,15
342,56,2011-08-22 16:50:01.677-04,4,11,15
343,57,2011-08-22 16:50:01.677-04,7,4,11
344,3,2011-08-22 16:51:02.584-04,12,5,17
345,5,2011-08-22 16:51:02.584-04,4,11,15
346,6,2011-08-22 16:51:02.584-04,7,8,15
347,8,2011-08-22 16:51:02.584-04,2,13,15
348,9,2011-08-22 16:51:02.584-04,8,11,19
349,10,2011-08-22 16:51:02.584-04,5,14,19
350,11,2011-08-22 16:51:02.584-04,6,9,15
351,12,2011-08-22 16:51:02.584-04,5,10,15
352,13,2011-08-22 16:51:02.584-04,1,14,15
353,14,2011-08-22 16:51:02.584-04,3,14,17
354,15,2011-08-22 16:51:02.584-04,3,12,15
355,16,2011-08-22 16:51:02.584-04,12,7,19
356,17,2011-08-22 16:51:02.584-04,6,9,15
357,18,2011-08-22 16:51:02.584-04,5,10,15
358,20,2011-08-22 16:51:02.584-04,15,4,19
359,21,2011-08-22 16:51:02.584-04,9,14,23
360,22,2011-08-22 16:51:02.584-04,23,24,47
361,23,2011-08-22 16:51:02.584-04,13,5,18
362,24,2011-08-22 16:51:02.584-04,14,1,15
363,25,2011-08-22 16:51:02.584-04,3,12,15
364,26,2011-08-22 16:51:02.584-04,7,8,15
365,27,2011-08-22 16:51:02.584-04,5,9,14
366,30,2011-08-22 16:51:02.584-04,5,10,15
367,31,2011-08-22 16:51:02.584-04,6,5,11
368,32,2011-08-22 16:51:02.584-04,5,6,11
369,33,2011-08-22 16:51:02.584-04,7,12,19
370,34,2011-08-22 16:51:02.584-04,10,5,15
371,35,2011-08-22 16:51:02.584-04,0,11,11
372,36,2011-08-22 16:51:02.584-04,1,15,16
373,37,2011-08-22 16:51:02.584-04,8,7,15
374,38,2011-08-22 16:51:02.584-04,19,16,35
375,39,2011-08-22 16:51:02.584-04,11,8,19
376,40,2011-08-22 16:51:02.584-04,9,4,13
377,41,2011-08-22 16:51:02.584-04,5,14,19
378,42,2011-08-22 16:51:02.584-04,8,11,19
379,43,2011-08-22 16:51:02.584-04,6,9,15
380,44,2011-08-22 16:51:02.584-04,18,1,19
381,45,2011-08-22 16:51:02.584-04,11,8,19
382,46,2011-08-22 16:51:02.584-04,11,8,19
383,47,2011-08-22 16:51:02.584-04,8,3,11
384,48,2011-08-22 16:51:02.584-04,3,12,15
385,49,2011-08-22 16:51:02.584-04,1,14,15
386,50,2011-08-22 16:51:02.584-04,0,15,15
387,51,2011-08-22 16:51:02.584-04,7,8,15
388,52,2011-08-22 16:51:02.584-04,8,6,14
389,53,2011-08-22 16:51:02.584-04,9,6,15
390,55,2011-08-22 16:51:02.584-04,1,14,15
391,56,2011-08-22 16:51:02.584-04,5,10,15
392,57,2011-08-22 16:51:02.584-04,7,4,11
393,3,2011-08-22 16:52:03.517-04,12,5,17
394,5,2011-08-22 16:52:03.517-04,4,11,15
395,6,2011-08-22 16:52:03.517-04,7,8,15
396,8,2011-08-22 16:52:03.517-04,2,13,15
397,9,2011-08-22 16:52:03.517-04,8,11,19
398,10,2011-08-22 16:52:03.517-04,5,14,19
399,11,2011-08-22 16:52:03.517-04,6,9,15
400,12,2011-08-22 16:52:03.517-04,5,10,15
401,13,2011-08-22 16:52:03.517-04,1,14,15
402,14,2011-08-22 16:52:03.517-04,3,14,17
403,15,2011-08-22 16:52:03.517-04,3,12,15
404,16,2011-08-22 16:52:03.517-04,12,7,19
405,17,2011-08-22 16:52:03.517-04,6,9,15
406,18,2011-08-22 16:52:03.517-04,5,10,15
407,20,2011-08-22 16:52:03.517-04,15,4,19
408,21,2011-08-22 16:52:03.517-04,9,14,23
409,22,2011-08-22 16:52:03.517-04,23,24,47
410,23,2011-08-22 16:52:03.517-04,13,5,18
411,24,2011-08-22 16:52:03.517-04,14,1,15
412,25,2011-08-22 16:52:03.517-04,3,12,15
413,26,2011-08-22 16:52:03.517-04,7,8,15
414,27,2011-08-22 16:52:03.517-04,5,9,14
415,30,2011-08-22 16:52:03.517-04,5,10,15
416,31,2011-08-22 16:52:03.517-04,6,5,11
417,32,2011-08-22 16:52:03.517-04,5,6,11
418,33,2011-08-22 16:52:03.517-04,7,12,19
419,34,2011-08-22 16:52:03.517-04,10,5,15
420,35,2011-08-22 16:52:03.517-04,0,11,11
421,36,2011-08-22 16:52:03.517-04,1,15,16
422,37,2011-08-22 16:52:03.517-04,8,7,15
423,38,2011-08-22 16:52:03.517-04,20,15,35
424,39,2011-08-22 16:52:03.517-04,11,8,19
425,40,2011-08-22 16:52:03.517-04,9,4,13
426,41,2011-08-22 16:52:03.517-04,5,14,19
427,42,2011-08-22 16:52:03.517-04,8,11,19
428,43,2011-08-22 16:52:03.517-04,6,9,15
429,44,2011-08-22 16:52:03.517-04,18,1,19
430,45,2011-08-22 16:52:03.517-04,11,8,19
431,46,2011-08-22 16:52:03.517-04,11,8,19
432,47,2011-08-22 16:52:03.517-04,8,3,11
433,48,2011-08-22 16:52:03.517-04,3,12,15
434,49,2011-08-22 16:52:03.517-04,1,14,15
435,50,2011-08-22 16:52:03.517-04,0,15,15
436,51,2011-08-22 16:52:03.517-04,7,8,15
437,52,2011-08-22 16:52:03.517-04,8,6,14
438,53,2011-08-22 16:52:03.517-04,9,6,15
439,55,2011-08-22 16:52:03.517-04,1,14,15
440,56,2011-08-22 16:52:03.517-04,5,10,15
441,57,2011-08-22 16:52:03.517-04,7,4,11
442,3,2011-08-22 16:53:04.469-04,12,5,17
443,5,2011-08-22 16:53:04.469-04,4,11,15
444,6,2011-08-22 16:53:04.469-04,7,8,15
445,8,2011-08-22 16:53:04.469-04,2,13,15
446,9,2011-08-22 16:53:04.469-04,8,11,19
447,10,2011-08-22 16:53:04.469-04,5,14,19
448,11,2011-08-22 16:53:04.469-04,6,9,15
449,12,2011-08-22 16:53:04.469-04,5,10,15
450,13,2011-08-22 16:53:04.469-04,1,14,15
451,14,2011-08-22 16:53:04.469-04,3,14,17
452,15,2011-08-22 16:53:04.469-04,4,11,15
453,16,2011-08-22 16:53:04.469-04,13,6,19
454,17,2011-08-22 16:53:04.469-04,6,9,15
455,18,2011-08-22 16:53:04.469-04,5,10,15
456,20,2011-08-22 16:53:04.469-04,15,4,19
457,21,2011-08-22 16:53:04.469-04,9,14,23
458,22,2011-08-22 16:53:04.469-04,23,24,47
459,23,2011-08-22 16:53:04.469-04,13,5,18
460,24,2011-08-22 16:53:04.469-04,13,2,15
461,25,2011-08-22 16:53:04.469-04,3,12,15
462,26,2011-08-22 16:53:04.469-04,7,8,15
463,27,2011-08-22 16:53:04.469-04,5,9,14
464,30,2011-08-22 16:53:04.469-04,5,10,15
465,31,2011-08-22 16:53:04.469-04,5,6,11
466,32,2011-08-22 16:53:04.469-04,5,6,11
467,33,2011-08-22 16:53:04.469-04,7,12,19
468,34,2011-08-22 16:53:04.469-04,10,5,15
469,35,2011-08-22 16:53:04.469-04,0,11,11
470,36,2011-08-22 16:53:04.469-04,0,16,16
471,37,2011-08-22 16:53:04.469-04,8,7,15
472,38,2011-08-22 16:53:04.469-04,20,15,35
473,39,2011-08-22 16:53:04.469-04,11,8,19
474,40,2011-08-22 16:53:04.469-04,8,5,13
475,41,2011-08-22 16:53:04.469-04,7,12,19
476,42,2011-08-22 16:53:04.469-04,8,11,19
477,43,2011-08-22 16:53:04.469-04,6,9,15
478,44,2011-08-22 16:53:04.469-04,18,1,19
479,45,2011-08-22 16:53:04.469-04,11,8,19
480,46,2011-08-22 16:53:04.469-04,11,8,19
481,47,2011-08-22 16:53:04.469-04,8,3,11
482,48,2011-08-22 16:53:04.469-04,3,12,15
483,49,2011-08-22 16:53:04.469-04,1,14,15
484,50,2011-08-22 16:53:04.469-04,0,15,15
485,51,2011-08-22 16:53:04.469-04,7,8,15
486,52,2011-08-22 16:53:04.469-04,8,6,14
487,53,2011-08-22 16:53:04.469-04,9,6,15
488,55,2011-08-22 16:53:04.469-04,0,15,15
489,56,2011-08-22 16:53:04.469-04,5,10,15
490,57,2011-08-22 16:53:04.469-04,7,4,11
491,3,2011-08-22 16:54:05.406-04,12,5,17
492,5,2011-08-22 16:54:05.406-04,5,10,15
493,6,2011-08-22 16:54:05.406-04,7,8,15
494,8,2011-08-22 16:54:05.406-04,2,13,15
495,9,2011-08-22 16:54:05.406-04,8,11,19
496,10,2011-08-22 16:54:05.406-04,5,14,19
497,11,2011-08-22 16:54:05.406-04,6,9,15
498,12,2011-08-22 16:54:05.406-04,5,10,15
499,13,2011-08-22 16:54:05.406-04,1,14,15
500,14,2011-08-22 16:54:05.406-04,3,14,17
501,15,2011-08-22 16:54:05.406-04,4,11,15
502,16,2011-08-22 16:54:05.406-04,13,6,19
503,17,2011-08-22 16:54:05.406-04,6,9,15
504,18,2011-08-22 16:54:05.406-04,5,10,15
505,20,2011-08-22 16:54:05.406-04,15,4,19
506,21,2011-08-22 16:54:05.406-04,9,14,23
507,22,2011-08-22 16:54:05.406-04,22,25,47
508,23,2011-08-22 16:54:05.406-04,13,5,18
509,24,2011-08-22 16:54:05.406-04,13,2,15
510,25,2011-08-22 16:54:05.406-04,3,12,15
511,26,2011-08-22 16:54:05.406-04,7,8,15
512,27,2011-08-22 16:54:05.406-04,5,9,14
513,30,2011-08-22 16:54:05.406-04,5,10,15
514,31,2011-08-22 16:54:05.406-04,5,6,11
515,32,2011-08-22 16:54:05.406-04,5,6,11
516,33,2011-08-22 16:54:05.406-04,7,12,19
517,34,2011-08-22 16:54:05.406-04,10,5,15
518,35,2011-08-22 16:54:05.406-04,0,11,11
519,36,2011-08-22 16:54:05.406-04,0,16,16
520,37,2011-08-22 16:54:05.406-04,8,7,15
521,38,2011-08-22 16:54:05.406-04,20,15,35
522,39,2011-08-22 16:54:05.406-04,11,8,19
523,40,2011-08-22 16:54:05.406-04,8,5,13
524,41,2011-08-22 16:54:05.406-04,7,12,19
525,42,2011-08-22 16:54:05.406-04,8,11,19
526,43,2011-08-22 16:54:05.406-04,6,9,15
527,44,2011-08-22 16:54:05.406-04,18,1,19
528,45,2011-08-22 16:54:05.406-04,11,8,19
529,46,2011-08-22 16:54:05.406-04,11,8,19
530,47,2011-08-22 16:54:05.406-04,8,3,11
531,48,2011-08-22 16:54:05.406-04,3,12,15
532,49,2011-08-22 16:54:05.406-04,2,13,15
533,50,2011-08-22 16:54:05.406-04,0,15,15
534,51,2011-08-22 16:54:05.406-04,7,8,15
535,52,2011-08-22 16:54:05.406-04,8,6,14
536,53,2011-08-22 16:54:05.406-04,9,6,15
537,55,2011-08-22 16:54:05.406-04,0,15,15
538,56,2011-08-22 16:54:05.406-04,5,10,15
539,57,2011-08-22 16:54:05.406-04,7,4,11
540,3,2011-08-22 16:55:06.549-04,12,5,17
541,5,2011-08-22 16:55:06.549-04,5,10,15
542,6,2011-08-22 16:55:06.549-04,7,8,15
543,8,2011-08-22 16:55:06.549-04,3,12,15
544,9,2011-08-22 16:55:06.549-04,8,11,19
545,10,2011-08-22 16:55:06.549-04,5,14,19
546,11,2011-08-22 16:55:06.549-04,6,9,15
547,12,2011-08-22 16:55:06.549-04,5,10,15
548,13,2011-08-22 16:55:06.549-04,1,14,15
549,14,2011-08-22 16:55:06.549-04,3,14,17
550,15,2011-08-22 16:55:06.549-04,4,11,15
551,16,2011-08-22 16:55:06.549-04,13,6,19
552,17,2011-08-22 16:55:06.549-04,5,10,15
553,18,2011-08-22 16:55:06.549-04,5,10,15
554,20,2011-08-22 16:55:06.549-04,15,4,19
555,21,2011-08-22 16:55:06.549-04,9,14,23
556,22,2011-08-22 16:55:06.549-04,22,25,47
557,23,2011-08-22 16:55:06.549-04,13,5,18
558,24,2011-08-22 16:55:06.549-04,13,2,15
559,25,2011-08-22 16:55:06.549-04,4,11,15
560,26,2011-08-22 16:55:06.549-04,7,8,15
561,27,2011-08-22 16:55:06.549-04,5,9,14
562,30,2011-08-22 16:55:06.549-04,5,10,15
563,31,2011-08-22 16:55:06.549-04,5,6,11
564,32,2011-08-22 16:55:06.549-04,5,6,11
565,33,2011-08-22 16:55:06.549-04,7,12,19
566,34,2011-08-22 16:55:06.549-04,10,5,15
567,35,2011-08-22 16:55:06.549-04,0,11,11
568,36,2011-08-22 16:55:06.549-04,0,16,16
569,37,2011-08-22 16:55:06.549-04,8,7,15
570,38,2011-08-22 16:55:06.549-04,20,15,35
571,39,2011-08-22 16:55:06.549-04,11,8,19
572,40,2011-08-22 16:55:06.549-04,7,6,13
573,41,2011-08-22 16:55:06.549-04,7,12,19
574,42,2011-08-22 16:55:06.549-04,8,11,19
575,43,2011-08-22 16:55:06.549-04,6,9,15
576,44,2011-08-22 16:55:06.549-04,18,1,19
577,45,2011-08-22 16:55:06.549-04,11,8,19
578,46,2011-08-22 16:55:06.549-04,11,8,19
579,47,2011-08-22 16:55:06.549-04,8,3,11
580,48,2011-08-22 16:55:06.549-04,3,12,15
581,49,2011-08-22 16:55:06.549-04,3,12,15
582,50,2011-08-22 16:55:06.549-04,0,15,15
583,51,2011-08-22 16:55:06.549-04,7,8,15
584,52,2011-08-22 16:55:06.549-04,8,6,14
585,53,2011-08-22 16:55:06.549-04,9,6,15
586,55,2011-08-22 16:55:06.549-04,0,15,15
587,56,2011-08-22 16:55:06.549-04,5,10,15
588,57,2011-08-22 16:55:06.549-04,7,4,11
589,3,2011-08-22 16:56:07.338-04,12,5,17
590,5,2011-08-22 16:56:07.338-04,5,10,15
591,6,2011-08-22 16:56:07.338-04,6,9,15
592,8,2011-08-22 16:56:07.338-04,3,12,15
593,9,2011-08-22 16:56:07.338-04,8,11,19
594,10,2011-08-22 16:56:07.338-04,5,14,19
595,11,2011-08-22 16:56:07.338-04,6,9,15
596,12,2011-08-22 16:56:07.338-04,5,10,15
597,13,2011-08-22 16:56:07.338-04,1,14,15
598,14,2011-08-22 16:56:07.338-04,3,14,17
599,15,2011-08-22 16:56:07.338-04,4,11,15
600,16,2011-08-22 16:56:07.338-04,13,6,19
601,17,2011-08-22 16:56:07.338-04,5,10,15
602,18,2011-08-22 16:56:07.338-04,5,10,15
603,20,2011-08-22 16:56:07.338-04,15,4,19
604,21,2011-08-22 16:56:07.338-04,9,14,23
605,22,2011-08-22 16:56:07.338-04,22,25,47
606,23,2011-08-22 16:56:07.338-04,13,5,18
607,24,2011-08-22 16:56:07.338-04,13,2,15
608,25,2011-08-22 16:56:07.338-04,4,11,15
609,26,2011-08-22 16:56:07.338-04,7,8,15
610,27,2011-08-22 16:56:07.338-04,5,9,14
611,30,2011-08-22 16:56:07.338-04,5,10,15
612,31,2011-08-22 16:56:07.338-04,5,6,11
613,32,2011-08-22 16:56:07.338-04,5,6,11
614,33,2011-08-22 16:56:07.338-04,7,12,19
615,34,2011-08-22 16:56:07.338-04,10,5,15
616,35,2011-08-22 16:56:07.338-04,0,11,11
617,36,2011-08-22 16:56:07.338-04,0,16,16
618,37,2011-08-22 16:56:07.338-04,8,7,15
619,38,2011-08-22 16:56:07.338-04,21,14,35
620,39,2011-08-22 16:56:07.338-04,11,8,19
621,40,2011-08-22 16:56:07.338-04,7,6,13
622,41,2011-08-22 16:56:07.338-04,7,12,19
623,42,2011-08-22 16:56:07.338-04,8,11,19
624,43,2011-08-22 16:56:07.338-04,6,9,15
625,44,2011-08-22 16:56:07.338-04,18,1,19
626,45,2011-08-22 16:56:07.338-04,11,8,19
627,46,2011-08-22 16:56:07.338-04,11,8,19
628,47,2011-08-22 16:56:07.338-04,8,3,11
629,48,2011-08-22 16:56:07.338-04,2,13,15
630,49,2011-08-22 16:56:07.338-04,3,12,15
631,50,2011-08-22 16:56:07.338-04,0,15,15
632,51,2011-08-22 16:56:07.338-04,7,8,15
633,52,2011-08-22 16:56:07.338-04,8,6,14
634,53,2011-08-22 16:56:07.338-04,9,6,15
635,55,2011-08-22 16:56:07.338-04,0,15,15
636,56,2011-08-22 16:56:07.338-04,5,10,15
637,57,2011-08-22 16:56:07.338-04,7,4,11
638,3,2011-08-22 16:56:07.338-04,12,5,17
639,5,2011-08-22 16:56:07.338-04,5,10,15
640,6,2011-08-22 16:56:07.338-04,6,9,15
641,8,2011-08-22 16:56:07.338-04,3,12,15
642,9,2011-08-22 16:56:07.338-04,8,11,19
643,10,2011-08-22 16:56:07.338-04,5,14,19
644,11,2011-08-22 16:56:07.338-04,6,9,15
645,12,2011-08-22 16:56:07.338-04,5,10,15
646,13,2011-08-22 16:56:07.338-04,1,14,15
647,14,2011-08-22 16:56:07.338-04,3,14,17
648,15,2011-08-22 16:56:07.338-04,4,11,15
649,16,2011-08-22 16:56:07.338-04,13,6,19
650,17,2011-08-22 16:56:07.338-04,5,10,15
651,18,2011-08-22 16:56:07.338-04,5,10,15
652,20,2011-08-22 16:56:07.338-04,15,4,19
653,21,2011-08-22 16:56:07.338-04,9,14,23
654,22,2011-08-22 16:56:07.338-04,22,25,47
655,23,2011-08-22 16:56:07.338-04,13,5,18
656,24,2011-08-22 16:56:07.338-04,13,2,15
657,25,2011-08-22 16:56:07.338-04,4,11,15
658,26,2011-08-22 16:56:07.338-04,7,8,15
659,27,2011-08-22 16:56:07.338-04,5,9,14
660,30,2011-08-22 16:56:07.338-04,5,10,15
661,31,2011-08-22 16:56:07.338-04,5,6,11
662,32,2011-08-22 16:56:07.338-04,5,6,11
663,33,2011-08-22 16:56:07.338-04,7,12,19
664,34,2011-08-22 16:56:07.338-04,10,5,15
665,35,2011-08-22 16:56:07.338-04,0,11,11
666,36,2011-08-22 16:56:07.338-04,0,16,16
667,37,2011-08-22 16:56:07.338-04,8,7,15
668,38,2011-08-22 16:56:07.338-04,21,14,35
669,39,2011-08-22 16:56:07.338-04,11,8,19
670,40,2011-08-22 16:56:07.338-04,7,6,13
671,41,2011-08-22 16:56:07.338-04,7,12,19
672,42,2011-08-22 16:56:07.338-04,8,11,19
673,43,2011-08-22 16:56:07.338-04,6,9,15
674,44,2011-08-22 16:56:07.338-04,18,1,19
675,45,2011-08-22 16:56:07.338-04,11,8,19
676,46,2011-08-22 16:56:07.338-04,11,8,19
677,47,2011-08-22 16:56:07.338-04,8,3,11
678,48,2011-08-22 16:56:07.338-04,2,13,15
679,49,2011-08-22 16:56:07.338-04,3,12,15
680,50,2011-08-22 16:56:07.338-04,0,15,15
681,51,2011-08-22 16:56:07.338-04,7,8,15
682,52,2011-08-22 16:56:07.338-04,8,6,14
683,53,2011-08-22 16:56:07.338-04,9,6,15
684,55,2011-08-22 16:56:07.338-04,0,15,15
685,56,2011-08-22 16:56:07.338-04,5,10,15
686,57,2011-08-22 16:56:07.338-04,7,4,11
687,3,2011-08-22 16:57:08.168-04,12,5,17
688,5,2011-08-22 16:57:08.168-04,5,10,15
689,6,2011-08-22 16:57:08.168-04,6,9,15
690,8,2011-08-22 16:57:08.168-04,3,12,15
691,9,2011-08-22 16:57:08.168-04,8,11,19
692,10,2011-08-22 16:57:08.168-04,5,14,19
693,11,2011-08-22 16:57:08.168-04,6,9,15
694,12,2011-08-22 16:57:08.168-04,5,10,15
695,13,2011-08-22 16:57:08.168-04,1,14,15
696,14,2011-08-22 16:57:08.168-04,3,14,17
697,15,2011-08-22 16:57:08.168-04,4,11,15
698,16,2011-08-22 16:57:08.168-04,13,6,19
699,17,2011-08-22 16:57:08.168-04,5,10,15
700,18,2011-08-22 16:57:08.168-04,5,10,15
701,20,2011-08-22 16:57:08.168-04,15,4,19
702,21,2011-08-22 16:57:08.168-04,9,14,23
703,22,2011-08-22 16:57:08.168-04,22,25,47
704,23,2011-08-22 16:57:08.168-04,13,5,18
705,24,2011-08-22 16:57:08.168-04,13,2,15
706,25,2011-08-22 16:57:08.168-04,5,10,15
707,26,2011-08-22 16:57:08.168-04,7,8,15
708,27,2011-08-22 16:57:08.168-04,5,9,14
709,30,2011-08-22 16:57:08.168-04,5,10,15
710,31,2011-08-22 16:57:08.168-04,5,6,11
711,32,2011-08-22 16:57:08.168-04,5,6,11
712,33,2011-08-22 16:57:08.168-04,7,12,19
713,34,2011-08-22 16:57:08.168-04,10,5,15
714,35,2011-08-22 16:57:08.168-04,0,11,11
715,36,2011-08-22 16:57:08.168-04,0,16,16
716,37,2011-08-22 16:57:08.168-04,8,7,15
717,38,2011-08-22 16:57:08.168-04,21,14,35
718,39,2011-08-22 16:57:08.168-04,11,8,19
719,40,2011-08-22 16:57:08.168-04,7,6,13
720,41,2011-08-22 16:57:08.168-04,7,12,19
721,42,2011-08-22 16:57:08.168-04,8,11,19
722,43,2011-08-22 16:57:08.168-04,6,9,15
723,44,2011-08-22 16:57:08.168-04,18,1,19
724,45,2011-08-22 16:57:08.168-04,12,7,19
725,46,2011-08-22 16:57:08.168-04,11,8,19
726,47,2011-08-22 16:57:08.168-04,8,3,11
727,48,2011-08-22 16:57:08.168-04,2,13,15
728,49,2011-08-22 16:57:08.168-04,3,12,15
729,50,2011-08-22 16:57:08.168-04,0,15,15
730,51,2011-08-22 16:57:08.168-04,7,8,15
731,52,2011-08-22 16:57:08.168-04,8,6,14
732,53,2011-08-22 16:57:08.168-04,10,5,15
733,55,2011-08-22 16:57:08.168-04,2,13,15
734,56,2011-08-22 16:57:08.168-04,5,10,15
735,57,2011-08-22 16:57:08.168-04,7,4,11
736,3,2011-08-22 16:58:09.099-04,12,5,17
737,5,2011-08-22 16:58:09.099-04,5,10,15
738,6,2011-08-22 16:58:09.099-04,6,9,15
739,8,2011-08-22 16:58:09.099-04,3,12,15
740,9,2011-08-22 16:58:09.099-04,8,11,19
741,10,2011-08-22 16:58:09.099-04,5,14,19
742,11,2011-08-22 16:58:09.099-04,6,9,15
743,12,2011-08-22 16:58:09.099-04,5,10,15
744,13,2011-08-22 16:58:09.099-04,0,15,15
745,14,2011-08-22 16:58:09.099-04,3,14,17
746,15,2011-08-22 16:58:09.099-04,4,11,15
747,16,2011-08-22 16:58:09.099-04,13,6,19
748,17,2011-08-22 16:58:09.099-04,5,10,15
749,18,2011-08-22 16:58:09.099-04,5,10,15
750,20,2011-08-22 16:58:09.099-04,15,4,19
751,21,2011-08-22 16:58:09.099-04,9,14,23
752,22,2011-08-22 16:58:09.099-04,21,26,47
753,23,2011-08-22 16:58:09.099-04,12,6,18
754,24,2011-08-22 16:58:09.099-04,12,3,15
755,25,2011-08-22 16:58:09.099-04,5,10,15
756,26,2011-08-22 16:58:09.099-04,7,8,15
757,27,2011-08-22 16:58:09.099-04,5,9,14
758,30,2011-08-22 16:58:09.099-04,5,10,15
759,31,2011-08-22 16:58:09.099-04,5,6,11
760,32,2011-08-22 16:58:09.099-04,5,6,11
761,33,2011-08-22 16:58:09.099-04,7,12,19
762,34,2011-08-22 16:58:09.099-04,10,5,15
763,35,2011-08-22 16:58:09.099-04,0,11,11
764,36,2011-08-22 16:58:09.099-04,0,16,16
765,37,2011-08-22 16:58:09.099-04,8,7,15
766,38,2011-08-22 16:58:09.099-04,22,13,35
767,39,2011-08-22 16:58:09.099-04,11,8,19
768,40,2011-08-22 16:58:09.099-04,7,6,13
769,41,2011-08-22 16:58:09.099-04,7,12,19
770,42,2011-08-22 16:58:09.099-04,8,11,19
771,43,2011-08-22 16:58:09.099-04,6,9,15
772,44,2011-08-22 16:58:09.099-04,18,1,19
773,45,2011-08-22 16:58:09.099-04,12,7,19
774,46,2011-08-22 16:58:09.099-04,11,8,19
775,47,2011-08-22 16:58:09.099-04,8,3,11
776,48,2011-08-22 16:58:09.099-04,2,13,15
777,49,2011-08-22 16:58:09.099-04,2,13,15
778,50,2011-08-22 16:58:09.099-04,2,13,15
779,51,2011-08-22 16:58:09.099-04,7,8,15
780,52,2011-08-22 16:58:09.099-04,8,6,14
781,53,2011-08-22 16:58:09.099-04,10,5,15
782,55,2011-08-22 16:58:09.099-04,2,13,15
783,56,2011-08-22 16:58:09.099-04,5,10,15
784,57,2011-08-22 16:58:09.099-04,7,4,11
785,3,2011-08-22 16:59:10.022-04,11,6,17
786,5,2011-08-22 16:59:10.022-04,5,10,15
787,6,2011-08-22 16:59:10.022-04,6,9,15
788,8,2011-08-22 16:59:10.022-04,3,12,15
789,9,2011-08-22 16:59:10.022-04,8,11,19
790,10,2011-08-22 16:59:10.022-04,5,14,19
791,11,2011-08-22 16:59:10.022-04,5,10,15
792,12,2011-08-22 16:59:10.022-04,5,10,15
793,13,2011-08-22 16:59:10.022-04,0,15,15
794,14,2011-08-22 16:59:10.022-04,3,14,17
795,15,2011-08-22 16:59:10.022-04,4,11,15
796,16,2011-08-22 16:59:10.022-04,13,6,19
797,17,2011-08-22 16:59:10.022-04,5,10,15
798,18,2011-08-22 16:59:10.022-04,5,10,15
799,20,2011-08-22 16:59:10.022-04,15,4,19
800,21,2011-08-22 16:59:10.022-04,9,14,23
801,22,2011-08-22 16:59:10.022-04,21,26,47
802,23,2011-08-22 16:59:10.022-04,12,6,18
803,24,2011-08-22 16:59:10.022-04,12,3,15
804,25,2011-08-22 16:59:10.022-04,5,10,15
805,26,2011-08-22 16:59:10.022-04,7,8,15
806,27,2011-08-22 16:59:10.022-04,5,9,14
807,30,2011-08-22 16:59:10.022-04,5,10,15
808,31,2011-08-22 16:59:10.022-04,5,6,11
809,32,2011-08-22 16:59:10.022-04,5,6,11
810,33,2011-08-22 16:59:10.022-04,7,12,19
811,34,2011-08-22 16:59:10.022-04,10,5,15
812,35,2011-08-22 16:59:10.022-04,0,11,11
813,36,2011-08-22 16:59:10.022-04,0,16,16
814,37,2011-08-22 16:59:10.022-04,8,7,15
815,38,2011-08-22 16:59:10.022-04,22,13,35
816,39,2011-08-22 16:59:10.022-04,11,8,19
817,40,2011-08-22 16:59:10.022-04,7,6,13
818,41,2011-08-22 16:59:10.022-04,7,12,19
819,42,2011-08-22 16:59:10.022-04,7,12,19
820,43,2011-08-22 16:59:10.022-04,6,9,15
821,44,2011-08-22 16:59:10.022-04,18,1,19
822,45,2011-08-22 16:59:10.022-04,12,7,19
823,46,2011-08-22 16:59:10.022-04,11,8,19
824,47,2011-08-22 16:59:10.022-04,8,3,11
825,48,2011-08-22 16:59:10.022-04,2,13,15
826,49,2011-08-22 16:59:10.022-04,1,14,15
827,50,2011-08-22 16:59:10.022-04,2,13,15
828,51,2011-08-22 16:59:10.022-04,7,8,15
829,52,2011-08-22 16:59:10.022-04,8,6,14
830,53,2011-08-22 16:59:10.022-04,10,5,15
831,55,2011-08-22 16:59:10.022-04,2,13,15
832,56,2011-08-22 16:59:10.022-04,5,10,15
833,57,2011-08-22 16:59:10.022-04,7,4,11
834,3,2011-08-22 17:00:10.977-04,11,6,17
835,5,2011-08-22 17:00:10.977-04,5,10,15
836,6,2011-08-22 17:00:10.977-04,6,9,15
837,8,2011-08-22 17:00:10.977-04,3,12,15
838,9,2011-08-22 17:00:10.977-04,8,11,19
839,10,2011-08-22 17:00:10.977-04,5,14,19
840,11,2011-08-22 17:00:10.977-04,5,10,15
841,12,2011-08-22 17:00:10.977-04,5,10,15
842,13,2011-08-22 17:00:10.977-04,0,15,15
843,14,2011-08-22 17:00:10.977-04,3,14,17
844,15,2011-08-22 17:00:10.977-04,4,11,15
845,16,2011-08-22 17:00:10.977-04,13,6,19
846,17,2011-08-22 17:00:10.977-04,5,10,15
847,18,2011-08-22 17:00:10.977-04,5,10,15
848,20,2011-08-22 17:00:10.977-04,15,4,19
849,21,2011-08-22 17:00:10.977-04,9,14,23
850,22,2011-08-22 17:00:10.977-04,20,27,47
851,23,2011-08-22 17:00:10.977-04,13,5,18
852,24,2011-08-22 17:00:10.977-04,10,5,15
853,25,2011-08-22 17:00:10.977-04,5,10,15
854,26,2011-08-22 17:00:10.977-04,7,8,15
855,27,2011-08-22 17:00:10.977-04,5,9,14
856,30,2011-08-22 17:00:10.977-04,5,10,15
857,31,2011-08-22 17:00:10.977-04,5,6,11
858,32,2011-08-22 17:00:10.977-04,5,6,11
859,33,2011-08-22 17:00:10.977-04,7,12,19
860,34,2011-08-22 17:00:10.977-04,10,5,15
861,35,2011-08-22 17:00:10.977-04,0,11,11
862,36,2011-08-22 17:00:10.977-04,0,16,16
863,37,2011-08-22 17:00:10.977-04,8,7,15
864,38,2011-08-22 17:00:10.977-04,22,13,35
865,39,2011-08-22 17:00:10.977-04,11,8,19
866,40,2011-08-22 17:00:10.977-04,7,6,13
867,41,2011-08-22 17:00:10.977-04,7,12,19
868,42,2011-08-22 17:00:10.977-04,7,12,19
869,43,2011-08-22 17:00:10.977-04,6,9,15
870,44,2011-08-22 17:00:10.977-04,18,1,19
871,45,2011-08-22 17:00:10.977-04,12,7,19
872,46,2011-08-22 17:00:10.977-04,11,8,19
873,47,2011-08-22 17:00:10.977-04,8,3,11
874,48,2011-08-22 17:00:10.977-04,2,13,15
875,49,2011-08-22 17:00:10.977-04,1,14,15
876,50,2011-08-22 17:00:10.977-04,2,13,15
877,51,2011-08-22 17:00:10.977-04,7,8,15
878,52,2011-08-22 17:00:10.977-04,9,5,14
879,53,2011-08-22 17:00:10.977-04,10,5,15
880,55,2011-08-22 17:00:10.977-04,2,13,15
881,56,2011-08-22 17:00:10.977-04,5,10,15
882,57,2011-08-22 17:00:10.977-04,7,4,11
883,3,2011-08-22 17:01:11.89-04,11,6,17
884,5,2011-08-22 17:01:11.89-04,5,10,15
885,6,2011-08-22 17:01:11.89-04,6,9,15
886,8,2011-08-22 17:01:11.89-04,3,12,15
887,9,2011-08-22 17:01:11.89-04,8,11,19
888,10,2011-08-22 17:01:11.89-04,5,14,19
889,11,2011-08-22 17:01:11.89-04,5,10,15
890,12,2011-08-22 17:01:11.89-04,5,10,15
891,13,2011-08-22 17:01:11.89-04,0,15,15
892,14,2011-08-22 17:01:11.89-04,1,16,17
893,15,2011-08-22 17:01:11.89-04,4,11,15
894,16,2011-08-22 17:01:11.89-04,13,6,19
895,17,2011-08-22 17:01:11.89-04,5,10,15
896,18,2011-08-22 17:01:11.89-04,5,10,15
897,20,2011-08-22 17:01:11.89-04,15,4,19
898,21,2011-08-22 17:01:11.89-04,9,14,23
899,22,2011-08-22 17:01:11.89-04,20,27,47
900,23,2011-08-22 17:01:11.89-04,13,5,18
901,24,2011-08-22 17:01:11.89-04,9,6,15
902,25,2011-08-22 17:01:11.89-04,5,10,15
903,26,2011-08-22 17:01:11.89-04,7,8,15
904,27,2011-08-22 17:01:11.89-04,5,9,14
905,30,2011-08-22 17:01:11.89-04,5,10,15
906,31,2011-08-22 17:01:11.89-04,5,6,11
907,32,2011-08-22 17:01:11.89-04,5,6,11
908,33,2011-08-22 17:01:11.89-04,7,12,19
909,34,2011-08-22 17:01:11.89-04,10,5,15
910,35,2011-08-22 17:01:11.89-04,0,11,11
911,36,2011-08-22 17:01:11.89-04,0,16,16
912,37,2011-08-22 17:01:11.89-04,8,7,15
913,38,2011-08-22 17:01:11.89-04,22,13,35
914,39,2011-08-22 17:01:11.89-04,11,8,19
915,40,2011-08-22 17:01:11.89-04,7,6,13
916,41,2011-08-22 17:01:11.89-04,7,12,19
917,42,2011-08-22 17:01:11.89-04,7,12,19
918,43,2011-08-22 17:01:11.89-04,6,9,15
919,44,2011-08-22 17:01:11.89-04,18,1,19
920,45,2011-08-22 17:01:11.89-04,12,7,19
921,46,2011-08-22 17:01:11.89-04,11,8,19
922,47,2011-08-22 17:01:11.89-04,8,3,11
923,48,2011-08-22 17:01:11.89-04,2,13,15
924,49,2011-08-22 17:01:11.89-04,1,14,15
925,50,2011-08-22 17:01:11.89-04,2,13,15
926,51,2011-08-22 17:01:11.89-04,7,8,15
927,52,2011-08-22 17:01:11.89-04,9,5,14
928,53,2011-08-22 17:01:11.89-04,10,5,15
929,55,2011-08-22 17:01:11.89-04,2,13,15
930,56,2011-08-22 17:01:11.89-04,5,10,15
931,57,2011-08-22 17:01:11.89-04,7,4,11
932,3,2011-08-22 17:02:12.781-04,11,6,17
933,5,2011-08-22 17:02:12.781-04,5,10,15
934,6,2011-08-22 17:02:12.781-04,6,9,15
935,8,2011-08-22 17:02:12.781-04,3,12,15
936,9,2011-08-22 17:02:12.781-04,8,11,19
937,10,2011-08-22 17:02:12.781-04,5,14,19
938,11,2011-08-22 17:02:12.781-04,5,10,15
939,12,2011-08-22 17:02:12.781-04,5,10,15
940,13,2011-08-22 17:02:12.781-04,0,15,15
941,14,2011-08-22 17:02:12.781-04,1,16,17
942,15,2011-08-22 17:02:12.781-04,4,11,15
943,16,2011-08-22 17:02:12.781-04,13,6,19
944,17,2011-08-22 17:02:12.781-04,5,10,15
945,18,2011-08-22 17:02:12.781-04,5,10,15
946,20,2011-08-22 17:02:12.781-04,15,4,19
947,21,2011-08-22 17:02:12.781-04,9,14,23
948,22,2011-08-22 17:02:12.781-04,21,26,47
949,23,2011-08-22 17:02:12.781-04,13,5,18
950,24,2011-08-22 17:02:12.781-04,9,6,15
951,25,2011-08-22 17:02:12.781-04,5,10,15
952,26,2011-08-22 17:02:12.781-04,7,8,15
953,27,2011-08-22 17:02:12.781-04,5,9,14
954,30,2011-08-22 17:02:12.781-04,5,10,15
955,31,2011-08-22 17:02:12.781-04,5,6,11
956,32,2011-08-22 17:02:12.781-04,5,6,11
957,33,2011-08-22 17:02:12.781-04,7,12,19
958,34,2011-08-22 17:02:12.781-04,10,5,15
959,35,2011-08-22 17:02:12.781-04,0,11,11
960,36,2011-08-22 17:02:12.781-04,1,15,16
961,37,2011-08-22 17:02:12.781-04,8,7,15
962,38,2011-08-22 17:02:12.781-04,22,13,35
963,39,2011-08-22 17:02:12.781-04,11,8,19
964,40,2011-08-22 17:02:12.781-04,7,6,13
965,41,2011-08-22 17:02:12.781-04,7,12,19
966,42,2011-08-22 17:02:12.781-04,7,12,19
967,43,2011-08-22 17:02:12.781-04,6,9,15
968,44,2011-08-22 17:02:12.781-04,18,1,19
969,45,2011-08-22 17:02:12.781-04,11,8,19
970,46,2011-08-22 17:02:12.781-04,11,8,19
971,47,2011-08-22 17:02:12.781-04,8,3,11
972,48,2011-08-22 17:02:12.781-04,2,13,15
973,49,2011-08-22 17:02:12.781-04,1,14,15
974,50,2011-08-22 17:02:12.781-04,2,13,15
975,51,2011-08-22 17:02:12.781-04,7,8,15
976,52,2011-08-22 17:02:12.781-04,9,5,14
977,53,2011-08-22 17:02:12.781-04,10,5,15
978,55,2011-08-22 17:02:12.781-04,2,13,15
979,56,2011-08-22 17:02:12.781-04,5,10,15
980,57,2011-08-22 17:02:12.781-04,7,4,11
981,3,2011-08-22 17:03:13.769-04,11,6,17
982,5,2011-08-22 17:03:13.769-04,5,10,15
983,6,2011-08-22 17:03:13.769-04,6,9,15
984,8,2011-08-22 17:03:13.769-04,3,12,15
985,9,2011-08-22 17:03:13.769-04,8,11,19
986,10,2011-08-22 17:03:13.769-04,5,14,19
987,11,2011-08-22 17:03:13.769-04,5,10,15
988,12,2011-08-22 17:03:13.769-04,5,10,15
989,13,2011-08-22 17:03:13.769-04,0,15,15
990,14,2011-08-22 17:03:13.769-04,1,16,17
991,15,2011-08-22 17:03:13.769-04,4,11,15
992,16,2011-08-22 17:03:13.769-04,13,6,19
993,17,2011-08-22 17:03:13.769-04,5,10,15
994,18,2011-08-22 17:03:13.769-04,5,10,15
995,20,2011-08-22 17:03:13.769-04,15,4,19
996,21,2011-08-22 17:03:13.769-04,9,14,23
997,22,2011-08-22 17:03:13.769-04,21,26,47
998,23,2011-08-22 17:03:13.769-04,13,5,18
999,24,2011-08-22 17:03:13.769-04,9,6,15
1000,25,2011-08-22 17:03:13.769-04,5,10,15
1001,26,2011-08-22 17:03:13.769-04,7,8,15
1002,27,2011-08-22 17:03:13.769-04,5,9,14
1003,30,2011-08-22 17:03:13.769-04,5,10,15
1004,31,2011-08-22 17:03:13.769-04,5,6,11
1005,32,2011-08-22 17:03:13.769-04,5,6,11
1006,33,2011-08-22 17:03:13.769-04,7,12,19
1007,34,2011-08-22 17:03:13.769-04,10,5,15
1008,35,2011-08-22 17:03:13.769-04,0,11,11
1009,36,2011-08-22 17:03:13.769-04,1,15,16
1010,37,2011-08-22 17:03:13.769-04,8,7,15
1011,38,2011-08-22 17:03:13.769-04,22,13,35
1012,39,2011-08-22 17:03:13.769-04,11,8,19
1013,40,2011-08-22 17:03:13.769-04,7,6,13
1014,41,2011-08-22 17:03:13.769-04,7,12,19
1015,42,2011-08-22 17:03:13.769-04,7,12,19
1016,43,2011-08-22 17:03:13.769-04,7,8,15
1017,44,2011-08-22 17:03:13.769-04,18,1,19
1018,45,2011-08-22 17:03:13.769-04,10,9,19
1019,46,2011-08-22 17:03:13.769-04,11,8,19
1020,47,2011-08-22 17:03:13.769-04,9,2,11
1021,48,2011-08-22 17:03:13.769-04,2,13,15
1022,49,2011-08-22 17:03:13.769-04,1,14,15
1023,50,2011-08-22 17:03:13.769-04,2,13,15
1024,51,2011-08-22 17:03:13.769-04,7,8,15
1025,52,2011-08-22 17:03:13.769-04,9,5,14
1026,53,2011-08-22 17:03:13.769-04,10,5,15
1027,55,2011-08-22 17:03:13.769-04,2,13,15
1028,56,2011-08-22 17:03:13.769-04,5,10,15
1029,57,2011-08-22 17:03:13.769-04,7,4,11
1030,3,2011-08-22 17:04:14.687-04,11,6,17
1031,5,2011-08-22 17:04:14.687-04,5,10,15
1032,6,2011-08-22 17:04:14.687-04,6,9,15
1033,8,2011-08-22 17:04:14.687-04,3,12,15
1034,9,2011-08-22 17:04:14.687-04,8,11,19
1035,10,2011-08-22 17:04:14.687-04,5,14,19
1036,11,2011-08-22 17:04:14.687-04,5,10,15
1037,12,2011-08-22 17:04:14.687-04,5,10,15
1038,13,2011-08-22 17:04:14.687-04,0,15,15
1039,14,2011-08-22 17:04:14.687-04,1,16,17
1040,15,2011-08-22 17:04:14.687-04,4,11,15
1041,16,2011-08-22 17:04:14.687-04,14,5,19
1042,17,2011-08-22 17:04:14.687-04,5,10,15
1043,18,2011-08-22 17:04:14.687-04,5,10,15
1044,20,2011-08-22 17:04:14.687-04,15,4,19
1045,21,2011-08-22 17:04:14.687-04,9,14,23
1046,22,2011-08-22 17:04:14.687-04,21,26,47
1047,23,2011-08-22 17:04:14.687-04,12,6,18
1048,24,2011-08-22 17:04:14.687-04,9,6,15
1049,25,2011-08-22 17:04:14.687-04,5,10,15
1050,26,2011-08-22 17:04:14.687-04,7,8,15
1051,27,2011-08-22 17:04:14.687-04,5,9,14
1052,30,2011-08-22 17:04:14.687-04,6,9,15
1053,31,2011-08-22 17:04:14.687-04,5,6,11
1054,32,2011-08-22 17:04:14.687-04,5,6,11
1055,33,2011-08-22 17:04:14.687-04,7,12,19
1056,34,2011-08-22 17:04:14.687-04,10,5,15
1057,35,2011-08-22 17:04:14.687-04,0,11,11
1058,36,2011-08-22 17:04:14.687-04,1,15,16
1059,37,2011-08-22 17:04:14.687-04,8,7,15
1060,38,2011-08-22 17:04:14.687-04,23,12,35
1061,39,2011-08-22 17:04:14.687-04,11,8,19
1062,40,2011-08-22 17:04:14.687-04,7,6,13
1063,41,2011-08-22 17:04:14.687-04,7,12,19
1064,42,2011-08-22 17:04:14.687-04,7,12,19
1065,43,2011-08-22 17:04:14.687-04,7,8,15
1066,44,2011-08-22 17:04:14.687-04,18,1,19
1067,45,2011-08-22 17:04:14.687-04,10,9,19
1068,46,2011-08-22 17:04:14.687-04,11,8,19
1069,47,2011-08-22 17:04:14.687-04,9,2,11
1070,48,2011-08-22 17:04:14.687-04,2,13,15
1071,49,2011-08-22 17:04:14.687-04,1,14,15
1072,50,2011-08-22 17:04:14.687-04,2,13,15
1073,51,2011-08-22 17:04:14.687-04,7,8,15
1074,52,2011-08-22 17:04:14.687-04,9,5,14
1075,53,2011-08-22 17:04:14.687-04,10,5,15
1076,55,2011-08-22 17:04:14.687-04,2,13,15
1077,56,2011-08-22 17:04:14.687-04,5,10,15
1078,57,2011-08-22 17:04:14.687-04,7,4,11
1079,3,2011-08-22 17:05:15.583-04,11,6,17
1080,5,2011-08-22 17:05:15.583-04,5,10,15
1081,6,2011-08-22 17:05:15.583-04,6,9,15
1082,8,2011-08-22 17:05:15.583-04,3,12,15
1083,9,2011-08-22 17:05:15.583-04,8,11,19
1084,10,2011-08-22 17:05:15.583-04,5,14,19
1085,11,2011-08-22 17:05:15.583-04,5,10,15
1086,12,2011-08-22 17:05:15.583-04,5,10,15
1087,13,2011-08-22 17:05:15.583-04,0,15,15
1088,14,2011-08-22 17:05:15.583-04,1,16,17
1089,15,2011-08-22 17:05:15.583-04,4,11,15
1090,16,2011-08-22 17:05:15.583-04,14,5,19
1091,17,2011-08-22 17:05:15.583-04,5,10,15
1092,18,2011-08-22 17:05:15.583-04,5,10,15
1093,20,2011-08-22 17:05:15.583-04,16,3,19
1094,21,2011-08-22 17:05:15.583-04,8,15,23
1095,22,2011-08-22 17:05:15.583-04,21,26,47
1096,23,2011-08-22 17:05:15.583-04,11,7,18
1097,24,2011-08-22 17:05:15.583-04,9,6,15
1098,25,2011-08-22 17:05:15.583-04,5,10,15
1099,26,2011-08-22 17:05:15.583-04,7,8,15
1100,27,2011-08-22 17:05:15.583-04,5,9,14
1101,30,2011-08-22 17:05:15.583-04,7,8,15
1102,31,2011-08-22 17:05:15.583-04,5,6,11
1103,32,2011-08-22 17:05:15.583-04,5,6,11
1104,33,2011-08-22 17:05:15.583-04,7,12,19
1105,34,2011-08-22 17:05:15.583-04,10,5,15
1106,35,2011-08-22 17:05:15.583-04,0,11,11
1107,36,2011-08-22 17:05:15.583-04,2,14,16
1108,37,2011-08-22 17:05:15.583-04,8,7,15
1109,38,2011-08-22 17:05:15.583-04,23,12,35
1110,39,2011-08-22 17:05:15.583-04,11,8,19
1111,40,2011-08-22 17:05:15.583-04,7,6,13
1112,41,2011-08-22 17:05:15.583-04,7,12,19
1113,42,2011-08-22 17:05:15.583-04,5,14,19
1114,43,2011-08-22 17:05:15.583-04,7,8,15
1115,44,2011-08-22 17:05:15.583-04,18,1,19
1116,45,2011-08-22 17:05:15.583-04,10,9,19
1117,46,2011-08-22 17:05:15.583-04,11,8,19
1118,47,2011-08-22 17:05:15.583-04,9,2,11
1119,48,2011-08-22 17:05:15.583-04,2,13,15
1120,49,2011-08-22 17:05:15.583-04,1,14,15
1121,50,2011-08-22 17:05:15.583-04,2,13,15
1122,51,2011-08-22 17:05:15.583-04,7,8,15
1123,52,2011-08-22 17:05:15.583-04,9,5,14
1124,53,2011-08-22 17:05:15.583-04,10,5,15
1125,55,2011-08-22 17:05:15.583-04,2,13,15
1126,56,2011-08-22 17:05:15.583-04,5,10,15
1127,57,2011-08-22 17:05:15.583-04,7,4,11
1128,3,2011-08-22 17:06:16.473-04,11,6,17
1129,5,2011-08-22 17:06:16.473-04,5,10,15
1130,6,2011-08-22 17:06:16.473-04,6,9,15
1131,8,2011-08-22 17:06:16.473-04,3,12,15
1132,9,2011-08-22 17:06:16.473-04,8,11,19
1133,10,2011-08-22 17:06:16.473-04,5,14,19
1134,11,2011-08-22 17:06:16.473-04,5,10,15
1135,12,2011-08-22 17:06:16.473-04,5,10,15
1136,13,2011-08-22 17:06:16.473-04,0,15,15
1137,14,2011-08-22 17:06:16.473-04,1,16,17
1138,15,2011-08-22 17:06:16.473-04,4,11,15
1139,16,2011-08-22 17:06:16.473-04,14,5,19
1140,17,2011-08-22 17:06:16.473-04,5,10,15
1141,18,2011-08-22 17:06:16.473-04,5,10,15
1142,20,2011-08-22 17:06:16.473-04,16,3,19
1143,21,2011-08-22 17:06:16.473-04,7,16,23
1144,22,2011-08-22 17:06:16.473-04,21,26,47
1145,23,2011-08-22 17:06:16.473-04,11,7,18
1146,24,2011-08-22 17:06:16.473-04,9,6,15
1147,25,2011-08-22 17:06:16.473-04,6,9,15
1148,26,2011-08-22 17:06:16.473-04,7,8,15
1149,27,2011-08-22 17:06:16.473-04,5,9,14
1150,30,2011-08-22 17:06:16.473-04,7,8,15
1151,31,2011-08-22 17:06:16.473-04,5,6,11
1152,32,2011-08-22 17:06:16.473-04,5,6,11
1153,33,2011-08-22 17:06:16.473-04,7,12,19
1154,34,2011-08-22 17:06:16.473-04,10,5,15
1155,35,2011-08-22 17:06:16.473-04,0,11,11
1156,36,2011-08-22 17:06:16.473-04,2,14,16
1157,37,2011-08-22 17:06:16.473-04,8,7,15
1158,38,2011-08-22 17:06:16.473-04,25,10,35
1159,39,2011-08-22 17:06:16.473-04,11,8,19
1160,40,2011-08-22 17:06:16.473-04,7,6,13
1161,41,2011-08-22 17:06:16.473-04,7,12,19
1162,42,2011-08-22 17:06:16.473-04,4,15,19
1163,43,2011-08-22 17:06:16.473-04,7,8,15
1164,44,2011-08-22 17:06:16.473-04,18,1,19
1165,45,2011-08-22 17:06:16.473-04,10,9,19
1166,46,2011-08-22 17:06:16.473-04,11,8,19
1167,47,2011-08-22 17:06:16.473-04,9,2,11
1168,48,2011-08-22 17:06:16.473-04,2,13,15
1169,49,2011-08-22 17:06:16.473-04,1,14,15
1170,50,2011-08-22 17:06:16.473-04,2,13,15
1171,51,2011-08-22 17:06:16.473-04,7,8,15
1172,52,2011-08-22 17:06:16.473-04,11,3,14
1173,53,2011-08-22 17:06:16.473-04,10,5,15
1174,55,2011-08-22 17:06:16.473-04,2,13,15
1175,56,2011-08-22 17:06:16.473-04,5,10,15
1176,57,2011-08-22 17:06:16.473-04,7,4,11
1177,3,2011-08-22 17:07:17.396-04,11,6,17
1178,5,2011-08-22 17:07:17.396-04,5,10,15
1179,6,2011-08-22 17:07:17.396-04,6,9,15
1180,8,2011-08-22 17:07:17.396-04,3,12,15
1181,9,2011-08-22 17:07:17.396-04,8,11,19
1182,10,2011-08-22 17:07:17.396-04,5,14,19
1183,11,2011-08-22 17:07:17.396-04,5,10,15
1184,12,2011-08-22 17:07:17.396-04,5,10,15
1185,13,2011-08-22 17:07:17.396-04,0,15,15
1186,14,2011-08-22 17:07:17.396-04,1,16,17
1187,15,2011-08-22 17:07:17.396-04,4,11,15
1188,16,2011-08-22 17:07:17.396-04,14,5,19
1189,17,2011-08-22 17:07:17.396-04,5,10,15
1190,18,2011-08-22 17:07:17.396-04,5,10,15
1191,20,2011-08-22 17:07:17.396-04,16,3,19
1192,21,2011-08-22 17:07:17.396-04,7,16,23
1193,22,2011-08-22 17:07:17.396-04,21,26,47
1194,23,2011-08-22 17:07:17.396-04,11,7,18
1195,24,2011-08-22 17:07:17.396-04,9,6,15
1196,25,2011-08-22 17:07:17.396-04,6,9,15
1197,26,2011-08-22 17:07:17.396-04,7,8,15
1198,27,2011-08-22 17:07:17.396-04,5,9,14
1199,30,2011-08-22 17:07:17.396-04,7,8,15
1200,31,2011-08-22 17:07:17.396-04,5,6,11
1201,32,2011-08-22 17:07:17.396-04,5,6,11
1202,33,2011-08-22 17:07:17.396-04,7,12,19
1203,34,2011-08-22 17:07:17.396-04,10,5,15
1204,35,2011-08-22 17:07:17.396-04,0,11,11
1205,36,2011-08-22 17:07:17.396-04,1,15,16
1206,37,2011-08-22 17:07:17.396-04,8,7,15
1207,38,2011-08-22 17:07:17.396-04,25,10,35
1208,39,2011-08-22 17:07:17.396-04,11,8,19
1209,40,2011-08-22 17:07:17.396-04,7,6,13
1210,41,2011-08-22 17:07:17.396-04,7,12,19
1211,42,2011-08-22 17:07:17.396-04,4,15,19
1212,43,2011-08-22 17:07:17.396-04,7,8,15
1213,44,2011-08-22 17:07:17.396-04,18,1,19
1214,45,2011-08-22 17:07:17.396-04,9,10,19
1215,46,2011-08-22 17:07:17.396-04,11,8,19
1216,47,2011-08-22 17:07:17.396-04,9,2,11
1217,48,2011-08-22 17:07:17.396-04,0,15,15
1218,49,2011-08-22 17:07:17.396-04,1,14,15
1219,50,2011-08-22 17:07:17.396-04,2,13,15
1220,51,2011-08-22 17:07:17.396-04,7,8,15
1221,52,2011-08-22 17:07:17.396-04,11,3,14
1222,53,2011-08-22 17:07:17.396-04,10,5,15
1223,55,2011-08-22 17:07:17.396-04,2,13,15
1224,56,2011-08-22 17:07:17.396-04,5,10,15
1225,57,2011-08-22 17:07:17.396-04,7,4,11
1226,3,2011-08-22 17:08:18.313-04,11,6,17
1227,5,2011-08-22 17:08:18.313-04,5,10,15
1228,6,2011-08-22 17:08:18.313-04,6,9,15
1229,8,2011-08-22 17:08:18.313-04,3,12,15
1230,9,2011-08-22 17:08:18.313-04,8,11,19
1231,10,2011-08-22 17:08:18.313-04,5,14,19
1232,11,2011-08-22 17:08:18.313-04,5,10,15
1233,12,2011-08-22 17:08:18.313-04,7,8,15
1234,13,2011-08-22 17:08:18.313-04,0,14,14
1235,14,2011-08-22 17:08:18.313-04,1,16,17
1236,15,2011-08-22 17:08:18.313-04,4,11,15
1237,16,2011-08-22 17:08:18.313-04,14,5,19
1238,17,2011-08-22 17:08:18.313-04,5,10,15
1239,18,2011-08-22 17:08:18.313-04,5,10,15
1240,20,2011-08-22 17:08:18.313-04,16,3,19
1241,21,2011-08-22 17:08:18.313-04,6,17,23
1242,22,2011-08-22 17:08:18.313-04,21,26,47
1243,23,2011-08-22 17:08:18.313-04,11,7,18
1244,24,2011-08-22 17:08:18.313-04,8,7,15
1245,25,2011-08-22 17:08:18.313-04,6,9,15
1246,26,2011-08-22 17:08:18.313-04,7,8,15
1247,27,2011-08-22 17:08:18.313-04,5,9,14
1248,30,2011-08-22 17:08:18.313-04,7,8,15
1249,31,2011-08-22 17:08:18.313-04,5,6,11
1250,32,2011-08-22 17:08:18.313-04,5,6,11
1251,33,2011-08-22 17:08:18.313-04,6,13,19
1252,34,2011-08-22 17:08:18.313-04,10,5,15
1253,35,2011-08-22 17:08:18.313-04,0,11,11
1254,36,2011-08-22 17:08:18.313-04,1,15,16
1255,37,2011-08-22 17:08:18.313-04,8,7,15
1256,38,2011-08-22 17:08:18.313-04,25,10,35
1257,39,2011-08-22 17:08:18.313-04,11,8,19
1258,40,2011-08-22 17:08:18.313-04,7,6,13
1259,41,2011-08-22 17:08:18.313-04,7,12,19
1260,42,2011-08-22 17:08:18.313-04,3,16,19
1261,43,2011-08-22 17:08:18.313-04,7,8,15
1262,44,2011-08-22 17:08:18.313-04,18,1,19
1263,45,2011-08-22 17:08:18.313-04,9,10,19
1264,46,2011-08-22 17:08:18.313-04,11,8,19
1265,47,2011-08-22 17:08:18.313-04,9,2,11
1266,48,2011-08-22 17:08:18.313-04,0,15,15
1267,49,2011-08-22 17:08:18.313-04,1,14,15
1268,50,2011-08-22 17:08:18.313-04,2,13,15
1269,51,2011-08-22 17:08:18.313-04,7,8,15
1270,52,2011-08-22 17:08:18.313-04,11,3,14
1271,53,2011-08-22 17:08:18.313-04,10,5,15
1272,55,2011-08-22 17:08:18.313-04,2,13,15
1273,56,2011-08-22 17:08:18.313-04,5,10,15
1274,57,2011-08-22 17:08:18.313-04,7,4,11
1275,3,2011-08-22 17:09:19.233-04,11,6,17
1276,5,2011-08-22 17:09:19.233-04,5,10,15
1277,6,2011-08-22 17:09:19.233-04,6,9,15
1278,8,2011-08-22 17:09:19.233-04,3,12,15
1279,9,2011-08-22 17:09:19.233-04,8,11,19
1280,10,2011-08-22 17:09:19.233-04,5,14,19
1281,11,2011-08-22 17:09:19.233-04,5,10,15
1282,12,2011-08-22 17:09:19.233-04,7,8,15
1283,13,2011-08-22 17:09:19.233-04,0,14,14
1284,14,2011-08-22 17:09:19.233-04,1,16,17
1285,15,2011-08-22 17:09:19.233-04,4,11,15
1286,16,2011-08-22 17:09:19.233-04,14,5,19
1287,17,2011-08-22 17:09:19.233-04,5,10,15
1288,18,2011-08-22 17:09:19.233-04,5,10,15
1289,20,2011-08-22 17:09:19.233-04,16,3,19
1290,21,2011-08-22 17:09:19.233-04,5,18,23
1291,22,2011-08-22 17:09:19.233-04,21,26,47
1292,23,2011-08-22 17:09:19.233-04,11,7,18
1293,24,2011-08-22 17:09:19.233-04,8,7,15
1294,25,2011-08-22 17:09:19.233-04,6,9,15
1295,26,2011-08-22 17:09:19.233-04,7,8,15
1296,27,2011-08-22 17:09:19.233-04,5,9,14
1297,30,2011-08-22 17:09:19.233-04,7,8,15
1298,31,2011-08-22 17:09:19.233-04,5,6,11
1299,32,2011-08-22 17:09:19.233-04,5,6,11
1300,33,2011-08-22 17:09:19.233-04,6,13,19
1301,34,2011-08-22 17:09:19.233-04,10,5,15
1302,35,2011-08-22 17:09:19.233-04,0,11,11
1303,36,2011-08-22 17:09:19.233-04,1,15,16
1304,37,2011-08-22 17:09:19.233-04,8,7,15
1305,38,2011-08-22 17:09:19.233-04,25,10,35
1306,39,2011-08-22 17:09:19.233-04,11,8,19
1307,40,2011-08-22 17:09:19.233-04,7,6,13
1308,41,2011-08-22 17:09:19.233-04,7,12,19
1309,42,2011-08-22 17:09:19.233-04,3,16,19
1310,43,2011-08-22 17:09:19.233-04,6,9,15
1311,44,2011-08-22 17:09:19.233-04,18,1,19
1312,45,2011-08-22 17:09:19.233-04,9,10,19
1313,46,2011-08-22 17:09:19.233-04,11,8,19
1314,47,2011-08-22 17:09:19.233-04,9,2,11
1315,48,2011-08-22 17:09:19.233-04,0,15,15
1316,49,2011-08-22 17:09:19.233-04,1,14,15
1317,50,2011-08-22 17:09:19.233-04,1,14,15
1318,51,2011-08-22 17:09:19.233-04,7,8,15
1319,52,2011-08-22 17:09:19.233-04,11,3,14
1320,53,2011-08-22 17:09:19.233-04,10,5,15
1321,55,2011-08-22 17:09:19.233-04,2,13,15
1322,56,2011-08-22 17:09:19.233-04,5,10,15
1323,57,2011-08-22 17:09:19.233-04,7,4,11
1324,3,2011-08-22 17:10:20.136-04,11,6,17
1325,5,2011-08-22 17:10:20.136-04,5,10,15
1326,6,2011-08-22 17:10:20.136-04,6,9,15
1327,8,2011-08-22 17:10:20.136-04,3,12,15
1328,9,2011-08-22 17:10:20.136-04,8,11,19
1329,10,2011-08-22 17:10:20.136-04,5,14,19
1330,11,2011-08-22 17:10:20.136-04,5,10,15
1331,12,2011-08-22 17:10:20.136-04,7,8,15
1332,13,2011-08-22 17:10:20.136-04,0,14,14
1333,14,2011-08-22 17:10:20.136-04,1,16,17
1334,15,2011-08-22 17:10:20.136-04,4,11,15
1335,16,2011-08-22 17:10:20.136-04,16,3,19
1336,17,2011-08-22 17:10:20.136-04,5,10,15
1337,18,2011-08-22 17:10:20.136-04,5,10,15
1338,20,2011-08-22 17:10:20.136-04,16,3,19
1339,21,2011-08-22 17:10:20.136-04,5,18,23
1340,22,2011-08-22 17:10:20.136-04,21,26,47
1341,23,2011-08-22 17:10:20.136-04,11,7,18
1342,24,2011-08-22 17:10:20.136-04,8,7,15
1343,25,2011-08-22 17:10:20.136-04,6,9,15
1344,26,2011-08-22 17:10:20.136-04,7,8,15
1345,27,2011-08-22 17:10:20.136-04,5,9,14
1346,30,2011-08-22 17:10:20.136-04,7,8,15
1347,31,2011-08-22 17:10:20.136-04,5,6,11
1348,32,2011-08-22 17:10:20.136-04,5,6,11
1349,33,2011-08-22 17:10:20.136-04,6,13,19
1350,34,2011-08-22 17:10:20.136-04,10,5,15
1351,35,2011-08-22 17:10:20.136-04,0,11,11
1352,36,2011-08-22 17:10:20.136-04,1,15,16
1353,37,2011-08-22 17:10:20.136-04,8,7,15
1354,38,2011-08-22 17:10:20.136-04,25,10,35
1355,39,2011-08-22 17:10:20.136-04,10,9,19
1356,40,2011-08-22 17:10:20.136-04,7,6,13
1357,41,2011-08-22 17:10:20.136-04,7,12,19
1358,42,2011-08-22 17:10:20.136-04,2,17,19
1359,43,2011-08-22 17:10:20.136-04,6,9,15
1360,44,2011-08-22 17:10:20.136-04,18,1,19
1361,45,2011-08-22 17:10:20.136-04,9,10,19
1362,46,2011-08-22 17:10:20.136-04,11,8,19
1363,47,2011-08-22 17:10:20.136-04,9,2,11
1364,48,2011-08-22 17:10:20.136-04,0,15,15
1365,49,2011-08-22 17:10:20.136-04,1,14,15
1366,50,2011-08-22 17:10:20.136-04,0,15,15
1367,51,2011-08-22 17:10:20.136-04,7,8,15
1368,52,2011-08-22 17:10:20.136-04,11,3,14
1369,53,2011-08-22 17:10:20.136-04,9,6,15
1370,55,2011-08-22 17:10:20.136-04,1,14,15
1371,56,2011-08-22 17:10:20.136-04,5,10,15
1372,57,2011-08-22 17:10:20.136-04,7,4,11
1373,3,2011-08-22 17:11:21.04-04,10,7,17
1374,5,2011-08-22 17:11:21.04-04,5,10,15
1375,6,2011-08-22 17:11:21.04-04,6,9,15
1376,8,2011-08-22 17:11:21.04-04,3,12,15
1377,9,2011-08-22 17:11:21.04-04,7,12,19
1378,10,2011-08-22 17:11:21.04-04,5,14,19
1379,11,2011-08-22 17:11:21.04-04,5,10,15
1380,12,2011-08-22 17:11:21.04-04,7,8,15
1381,13,2011-08-22 17:11:21.04-04,0,14,14
1382,14,2011-08-22 17:11:21.04-04,1,16,17
1383,15,2011-08-22 17:11:21.04-04,4,11,15
1384,16,2011-08-22 17:11:21.04-04,16,3,19
1385,17,2011-08-22 17:11:21.04-04,5,10,15
1386,18,2011-08-22 17:11:21.04-04,5,10,15
1387,20,2011-08-22 17:11:21.04-04,16,3,19
1388,21,2011-08-22 17:11:21.04-04,4,19,23
1389,22,2011-08-22 17:11:21.04-04,20,27,47
1390,23,2011-08-22 17:11:21.04-04,11,7,18
1391,24,2011-08-22 17:11:21.04-04,8,7,15
1392,25,2011-08-22 17:11:21.04-04,6,9,15
1393,26,2011-08-22 17:11:21.04-04,7,8,15
1394,27,2011-08-22 17:11:21.04-04,5,9,14
1395,30,2011-08-22 17:11:21.04-04,7,8,15
1396,31,2011-08-22 17:11:21.04-04,5,6,11
1397,32,2011-08-22 17:11:21.04-04,5,6,11
1398,33,2011-08-22 17:11:21.04-04,6,13,19
1399,34,2011-08-22 17:11:21.04-04,10,5,15
1400,35,2011-08-22 17:11:21.04-04,0,11,11
1401,36,2011-08-22 17:11:21.04-04,1,15,16
1402,37,2011-08-22 17:11:21.04-04,8,7,15
1403,38,2011-08-22 17:11:21.04-04,26,9,35
1404,39,2011-08-22 17:11:21.04-04,10,9,19
1405,40,2011-08-22 17:11:21.04-04,7,6,13
1406,41,2011-08-22 17:11:21.04-04,7,12,19
1407,42,2011-08-22 17:11:21.04-04,2,17,19
1408,43,2011-08-22 17:11:21.04-04,6,9,15
1409,44,2011-08-22 17:11:21.04-04,18,1,19
1410,45,2011-08-22 17:11:21.04-04,9,10,19
1411,46,2011-08-22 17:11:21.04-04,11,8,19
1412,47,2011-08-22 17:11:21.04-04,9,2,11
1413,48,2011-08-22 17:11:21.04-04,0,15,15
1414,49,2011-08-22 17:11:21.04-04,1,14,15
1415,50,2011-08-22 17:11:21.04-04,0,15,15
1416,51,2011-08-22 17:11:21.04-04,7,8,15
1417,52,2011-08-22 17:11:21.04-04,11,3,14
1418,53,2011-08-22 17:11:21.04-04,9,6,15
1419,55,2011-08-22 17:11:21.04-04,1,14,15
1420,56,2011-08-22 17:11:21.04-04,5,10,15
1421,57,2011-08-22 17:11:21.04-04,7,4,11
1422,3,2011-08-22 17:12:21.937-04,10,7,17
1423,5,2011-08-22 17:12:21.937-04,5,10,15
1424,6,2011-08-22 17:12:21.937-04,6,9,15
1425,8,2011-08-22 17:12:21.937-04,3,12,15
1426,9,2011-08-22 17:12:21.937-04,7,12,19
1427,10,2011-08-22 17:12:21.937-04,5,14,19
1428,11,2011-08-22 17:12:21.937-04,4,11,15
1429,12,2011-08-22 17:12:21.937-04,7,8,15
1430,13,2011-08-22 17:12:21.937-04,0,14,14
1431,14,2011-08-22 17:12:21.937-04,1,16,17
1432,15,2011-08-22 17:12:21.937-04,4,11,15
1433,16,2011-08-22 17:12:21.937-04,16,3,19
1434,17,2011-08-22 17:12:21.937-04,5,10,15
1435,18,2011-08-22 17:12:21.937-04,5,10,15
1436,20,2011-08-22 17:12:21.937-04,16,3,19
1437,21,2011-08-22 17:12:21.937-04,4,19,23
1438,22,2011-08-22 17:12:21.937-04,20,27,47
1439,23,2011-08-22 17:12:21.937-04,11,7,18
1440,24,2011-08-22 17:12:21.937-04,8,7,15
1441,25,2011-08-22 17:12:21.937-04,6,9,15
1442,26,2011-08-22 17:12:21.937-04,7,8,15
1443,27,2011-08-22 17:12:21.937-04,5,9,14
1444,30,2011-08-22 17:12:21.937-04,7,8,15
1445,31,2011-08-22 17:12:21.937-04,5,6,11
1446,32,2011-08-22 17:12:21.937-04,5,6,11
1447,33,2011-08-22 17:12:21.937-04,6,13,19
1448,34,2011-08-22 17:12:21.937-04,9,6,15
1449,35,2011-08-22 17:12:21.937-04,0,11,11
1450,36,2011-08-22 17:12:21.937-04,1,15,16
1451,37,2011-08-22 17:12:21.937-04,8,7,15
1452,38,2011-08-22 17:12:21.937-04,26,9,35
1453,39,2011-08-22 17:12:21.937-04,10,9,19
1454,40,2011-08-22 17:12:21.937-04,7,6,13
1455,41,2011-08-22 17:12:21.937-04,7,12,19
1456,42,2011-08-22 17:12:21.937-04,2,17,19
1457,43,2011-08-22 17:12:21.937-04,6,9,15
1458,44,2011-08-22 17:12:21.937-04,18,1,19
1459,45,2011-08-22 17:12:21.937-04,9,10,19
1460,46,2011-08-22 17:12:21.937-04,11,8,19
1461,47,2011-08-22 17:12:21.937-04,9,2,11
1462,48,2011-08-22 17:12:21.937-04,0,15,15
1463,49,2011-08-22 17:12:21.937-04,2,13,15
1464,50,2011-08-22 17:12:21.937-04,0,15,15
1465,51,2011-08-22 17:12:21.937-04,7,8,15
1466,52,2011-08-22 17:12:21.937-04,11,3,14
1467,53,2011-08-22 17:12:21.937-04,9,6,15
1468,55,2011-08-22 17:12:21.937-04,1,14,15
1469,56,2011-08-22 17:12:21.937-04,5,10,15
1470,57,2011-08-22 17:12:21.937-04,7,4,11
1471,3,2011-08-22 17:13:22.873-04,10,7,17
1472,5,2011-08-22 17:13:22.873-04,5,10,15
1473,6,2011-08-22 17:13:22.873-04,6,9,15
1474,8,2011-08-22 17:13:22.873-04,3,12,15
1475,9,2011-08-22 17:13:22.873-04,7,12,19
1476,10,2011-08-22 17:13:22.873-04,5,14,19
1477,11,2011-08-22 17:13:22.873-04,4,11,15
1478,12,2011-08-22 17:13:22.873-04,7,8,15
1479,13,2011-08-22 17:13:22.873-04,0,14,14
1480,14,2011-08-22 17:13:22.873-04,0,17,17
1481,15,2011-08-22 17:13:22.873-04,4,11,15
1482,16,2011-08-22 17:13:22.873-04,16,3,19
1483,17,2011-08-22 17:13:22.873-04,5,10,15
1484,18,2011-08-22 17:13:22.873-04,5,10,15
1485,20,2011-08-22 17:13:22.873-04,16,3,19
1486,21,2011-08-22 17:13:22.873-04,4,19,23
1487,22,2011-08-22 17:13:22.873-04,20,27,47
1488,23,2011-08-22 17:13:22.873-04,11,7,18
1489,24,2011-08-22 17:13:22.873-04,8,7,15
1490,25,2011-08-22 17:13:22.873-04,6,9,15
1491,26,2011-08-22 17:13:22.873-04,7,8,15
1492,27,2011-08-22 17:13:22.873-04,5,9,14
1493,30,2011-08-22 17:13:22.873-04,7,8,15
1494,31,2011-08-22 17:13:22.873-04,5,6,11
1495,32,2011-08-22 17:13:22.873-04,5,6,11
1496,33,2011-08-22 17:13:22.873-04,6,13,19
1497,34,2011-08-22 17:13:22.873-04,9,6,15
1498,35,2011-08-22 17:13:22.873-04,0,11,11
1499,36,2011-08-22 17:13:22.873-04,1,15,16
1500,37,2011-08-22 17:13:22.873-04,8,7,15
1501,38,2011-08-22 17:13:22.873-04,27,8,35
1502,39,2011-08-22 17:13:22.873-04,10,9,19
1503,40,2011-08-22 17:13:22.873-04,7,6,13
1504,41,2011-08-22 17:13:22.873-04,7,12,19
1505,42,2011-08-22 17:13:22.873-04,2,17,19
1506,43,2011-08-22 17:13:22.873-04,6,9,15
1507,44,2011-08-22 17:13:22.873-04,18,1,19
1508,45,2011-08-22 17:13:22.873-04,9,10,19
1509,46,2011-08-22 17:13:22.873-04,11,8,19
1510,47,2011-08-22 17:13:22.873-04,9,2,11
1511,48,2011-08-22 17:13:22.873-04,0,15,15
1512,49,2011-08-22 17:13:22.873-04,2,13,15
1513,50,2011-08-22 17:13:22.873-04,0,15,15
1514,51,2011-08-22 17:13:22.873-04,7,8,15
1515,52,2011-08-22 17:13:22.873-04,11,3,14
1516,53,2011-08-22 17:13:22.873-04,9,6,15
1517,55,2011-08-22 17:13:22.873-04,1,14,15
1518,56,2011-08-22 17:13:22.873-04,5,10,15
1519,57,2011-08-22 17:13:22.873-04,7,4,11
1520,3,2011-08-22 17:14:23.736-04,10,7,17
1521,5,2011-08-22 17:14:23.736-04,5,10,15
1522,6,2011-08-22 17:14:23.736-04,6,9,15
1523,8,2011-08-22 17:14:23.736-04,3,12,15
1524,9,2011-08-22 17:14:23.736-04,7,12,19
1525,10,2011-08-22 17:14:23.736-04,5,14,19
1526,11,2011-08-22 17:14:23.736-04,4,11,15
1527,12,2011-08-22 17:14:23.736-04,7,8,15
1528,13,2011-08-22 17:14:23.736-04,0,14,14
1529,14,2011-08-22 17:14:23.736-04,0,17,17
1530,15,2011-08-22 17:14:23.736-04,4,11,15
1531,16,2011-08-22 17:14:23.736-04,16,3,19
1532,17,2011-08-22 17:14:23.736-04,5,10,15
1533,18,2011-08-22 17:14:23.736-04,5,10,15
1534,20,2011-08-22 17:14:23.736-04,16,3,19
1535,21,2011-08-22 17:14:23.736-04,4,19,23
1536,22,2011-08-22 17:14:23.736-04,19,28,47
1537,23,2011-08-22 17:14:23.736-04,11,7,18
1538,24,2011-08-22 17:14:23.736-04,8,7,15
1539,25,2011-08-22 17:14:23.736-04,6,9,15
1540,26,2011-08-22 17:14:23.736-04,7,8,15
1541,27,2011-08-22 17:14:23.736-04,4,10,14
1542,30,2011-08-22 17:14:23.736-04,7,8,15
1543,31,2011-08-22 17:14:23.736-04,5,6,11
1544,32,2011-08-22 17:14:23.736-04,5,6,11
1545,33,2011-08-22 17:14:23.736-04,5,14,19
1546,34,2011-08-22 17:14:23.736-04,9,6,15
1547,35,2011-08-22 17:14:23.736-04,0,11,11
1548,36,2011-08-22 17:14:23.736-04,1,15,16
1549,37,2011-08-22 17:14:23.736-04,8,7,15
1550,38,2011-08-22 17:14:23.736-04,28,7,35
1551,39,2011-08-22 17:14:23.736-04,10,9,19
1552,40,2011-08-22 17:14:23.736-04,7,6,13
1553,41,2011-08-22 17:14:23.736-04,7,12,19
1554,42,2011-08-22 17:14:23.736-04,2,17,19
1555,43,2011-08-22 17:14:23.736-04,6,9,15
1556,44,2011-08-22 17:14:23.736-04,18,1,19
1557,45,2011-08-22 17:14:23.736-04,9,10,19
1558,46,2011-08-22 17:14:23.736-04,11,8,19
1559,47,2011-08-22 17:14:23.736-04,9,2,11
1560,48,2011-08-22 17:14:23.736-04,0,15,15
1561,49,2011-08-22 17:14:23.736-04,2,13,15
1562,50,2011-08-22 17:14:23.736-04,0,15,15
1563,51,2011-08-22 17:14:23.736-04,7,8,15
1564,52,2011-08-22 17:14:23.736-04,11,3,14
1565,53,2011-08-22 17:14:23.736-04,9,6,15
1566,55,2011-08-22 17:14:23.736-04,1,14,15
1567,56,2011-08-22 17:14:23.736-04,5,10,15
1568,57,2011-08-22 17:14:23.736-04,7,4,11
1569,3,2011-08-22 17:15:24.948-04,9,8,17
1570,5,2011-08-22 17:15:24.948-04,3,12,15
1571,6,2011-08-22 17:15:24.948-04,6,9,15
1572,8,2011-08-22 17:15:24.948-04,3,12,15
1573,9,2011-08-22 17:15:24.948-04,7,12,19
1574,10,2011-08-22 17:15:24.948-04,5,14,19
1575,11,2011-08-22 17:15:24.948-04,4,11,15
1576,12,2011-08-22 17:15:24.948-04,7,8,15
1577,13,2011-08-22 17:15:24.948-04,0,14,14
1578,14,2011-08-22 17:15:24.948-04,0,17,17
1579,15,2011-08-22 17:15:24.948-04,4,11,15
1580,16,2011-08-22 17:15:24.948-04,16,3,19
1581,17,2011-08-22 17:15:24.948-04,5,10,15
1582,18,2011-08-22 17:15:24.948-04,5,10,15
1583,20,2011-08-22 17:15:24.948-04,16,3,19
1584,21,2011-08-22 17:15:24.948-04,4,19,23
1585,22,2011-08-22 17:15:24.948-04,19,28,47
1586,23,2011-08-22 17:15:24.948-04,11,7,18
1587,24,2011-08-22 17:15:24.948-04,8,7,15
1588,25,2011-08-22 17:15:24.948-04,6,9,15
1589,26,2011-08-22 17:15:24.948-04,7,8,15
1590,27,2011-08-22 17:15:24.948-04,4,10,14
1591,30,2011-08-22 17:15:24.948-04,7,8,15
1592,31,2011-08-22 17:15:24.948-04,5,6,11
1593,32,2011-08-22 17:15:24.948-04,5,6,11
1594,33,2011-08-22 17:15:24.948-04,5,14,19
1595,34,2011-08-22 17:15:24.948-04,9,6,15
1596,35,2011-08-22 17:15:24.948-04,0,11,11
1597,36,2011-08-22 17:15:24.948-04,1,15,16
1598,37,2011-08-22 17:15:24.948-04,8,7,15
1599,38,2011-08-22 17:15:24.948-04,28,7,35
1600,39,2011-08-22 17:15:24.948-04,10,9,19
1601,40,2011-08-22 17:15:24.948-04,7,6,13
1602,41,2011-08-22 17:15:24.948-04,7,12,19
1603,42,2011-08-22 17:15:24.948-04,2,17,19
1604,43,2011-08-22 17:15:24.948-04,6,9,15
1605,44,2011-08-22 17:15:24.948-04,18,1,19
1606,45,2011-08-22 17:15:24.948-04,9,10,19
1607,46,2011-08-22 17:15:24.948-04,10,9,19
1608,47,2011-08-22 17:15:24.948-04,9,2,11
1609,48,2011-08-22 17:15:24.948-04,0,15,15
1610,49,2011-08-22 17:15:24.948-04,2,13,15
1611,50,2011-08-22 17:15:24.948-04,0,15,15
1612,51,2011-08-22 17:15:24.948-04,7,8,15
1613,52,2011-08-22 17:15:24.948-04,10,4,14
1614,53,2011-08-22 17:15:24.948-04,9,6,15
1615,55,2011-08-22 17:15:24.948-04,1,14,15
1616,56,2011-08-22 17:15:24.948-04,5,10,15
1617,57,2011-08-22 17:15:24.948-04,8,3,11
1618,3,2011-08-22 17:16:25.917-04,9,8,17
1619,5,2011-08-22 17:16:25.917-04,3,12,15
1620,6,2011-08-22 17:16:25.917-04,6,9,15
1621,8,2011-08-22 17:16:25.917-04,3,12,15
1622,9,2011-08-22 17:16:25.917-04,7,12,19
1623,10,2011-08-22 17:16:25.917-04,5,14,19
1624,11,2011-08-22 17:16:25.917-04,5,10,15
1625,12,2011-08-22 17:16:25.917-04,8,7,15
1626,13,2011-08-22 17:16:25.917-04,0,14,14
1627,14,2011-08-22 17:16:25.917-04,0,17,17
1628,15,2011-08-22 17:16:25.917-04,4,11,15
1629,16,2011-08-22 17:16:25.917-04,16,3,19
1630,17,2011-08-22 17:16:25.917-04,5,10,15
1631,18,2011-08-22 17:16:25.917-04,5,10,15
1632,20,2011-08-22 17:16:25.917-04,16,3,19
1633,21,2011-08-22 17:16:25.917-04,4,19,23
1634,22,2011-08-22 17:16:25.917-04,19,28,47
1635,23,2011-08-22 17:16:25.917-04,11,7,18
1636,24,2011-08-22 17:16:25.917-04,8,7,15
1637,25,2011-08-22 17:16:25.917-04,6,9,15
1638,26,2011-08-22 17:16:25.917-04,7,8,15
1639,27,2011-08-22 17:16:25.917-04,4,10,14
1640,30,2011-08-22 17:16:25.917-04,7,8,15
1641,31,2011-08-22 17:16:25.917-04,5,6,11
1642,32,2011-08-22 17:16:25.917-04,5,6,11
1643,33,2011-08-22 17:16:25.917-04,4,15,19
1644,34,2011-08-22 17:16:25.917-04,9,6,15
1645,35,2011-08-22 17:16:25.917-04,0,11,11
1646,36,2011-08-22 17:16:25.917-04,0,16,16
1647,37,2011-08-22 17:16:25.917-04,8,7,15
1648,38,2011-08-22 17:16:25.917-04,29,6,35
1649,39,2011-08-22 17:16:25.917-04,9,10,19
1650,40,2011-08-22 17:16:25.917-04,7,6,13
1651,41,2011-08-22 17:16:25.917-04,7,12,19
1652,42,2011-08-22 17:16:25.917-04,2,17,19
1653,43,2011-08-22 17:16:25.917-04,8,7,15
1654,44,2011-08-22 17:16:25.917-04,18,1,19
1655,45,2011-08-22 17:16:25.917-04,9,10,19
1656,46,2011-08-22 17:16:25.917-04,10,9,19
1657,47,2011-08-22 17:16:25.917-04,9,2,11
1658,48,2011-08-22 17:16:25.917-04,0,15,15
1659,49,2011-08-22 17:16:25.917-04,2,13,15
1660,50,2011-08-22 17:16:25.917-04,0,15,15
1661,51,2011-08-22 17:16:25.917-04,7,8,15
1662,52,2011-08-22 17:16:25.917-04,10,4,14
1663,53,2011-08-22 17:16:25.917-04,9,6,15
1664,55,2011-08-22 17:16:25.917-04,1,14,15
1665,56,2011-08-22 17:16:25.917-04,5,10,15
1666,57,2011-08-22 17:16:25.917-04,8,3,11
1667,3,2011-08-22 17:17:27.126-04,9,8,17
1668,5,2011-08-22 17:17:27.126-04,3,12,15
1669,6,2011-08-22 17:17:27.126-04,6,9,15
1670,8,2011-08-22 17:17:27.126-04,3,12,15
1671,9,2011-08-22 17:17:27.126-04,7,12,19
1672,10,2011-08-22 17:17:27.126-04,5,14,19
1673,11,2011-08-22 17:17:27.126-04,5,10,15
1674,12,2011-08-22 17:17:27.126-04,8,7,15
1675,13,2011-08-22 17:17:27.126-04,0,14,14
1676,14,2011-08-22 17:17:27.126-04,0,17,17
1677,15,2011-08-22 17:17:27.126-04,4,11,15
1678,16,2011-08-22 17:17:27.126-04,16,3,19
1679,17,2011-08-22 17:17:27.126-04,5,10,15
1680,18,2011-08-22 17:17:27.126-04,5,10,15
1681,20,2011-08-22 17:17:27.126-04,16,3,19
1682,21,2011-08-22 17:17:27.126-04,4,19,23
1683,22,2011-08-22 17:17:27.126-04,19,28,47
1684,23,2011-08-22 17:17:27.126-04,11,7,18
1685,24,2011-08-22 17:17:27.126-04,8,7,15
1686,25,2011-08-22 17:17:27.126-04,6,9,15
1687,26,2011-08-22 17:17:27.126-04,7,8,15
1688,27,2011-08-22 17:17:27.126-04,4,10,14
1689,30,2011-08-22 17:17:27.126-04,7,8,15
1690,31,2011-08-22 17:17:27.126-04,5,6,11
1691,32,2011-08-22 17:17:27.126-04,5,6,11
1692,33,2011-08-22 17:17:27.126-04,4,15,19
1693,34,2011-08-22 17:17:27.126-04,9,6,15
1694,35,2011-08-22 17:17:27.126-04,0,11,11
1695,36,2011-08-22 17:17:27.126-04,0,16,16
1696,37,2011-08-22 17:17:27.126-04,8,7,15
1697,38,2011-08-22 17:17:27.126-04,30,5,35
1698,39,2011-08-22 17:17:27.126-04,9,10,19
1699,40,2011-08-22 17:17:27.126-04,7,6,13
1700,41,2011-08-22 17:17:27.126-04,7,12,19
1701,42,2011-08-22 17:17:27.126-04,2,17,19
1702,43,2011-08-22 17:17:27.126-04,8,7,15
1703,44,2011-08-22 17:17:27.126-04,17,2,19
1704,45,2011-08-22 17:17:27.126-04,9,10,19
1705,46,2011-08-22 17:17:27.126-04,10,9,19
1706,47,2011-08-22 17:17:27.126-04,9,2,11
1707,48,2011-08-22 17:17:27.126-04,0,15,15
1708,49,2011-08-22 17:17:27.126-04,2,13,15
1709,50,2011-08-22 17:17:27.126-04,0,15,15
1710,51,2011-08-22 17:17:27.126-04,7,8,15
1711,52,2011-08-22 17:17:27.126-04,10,4,14
1712,53,2011-08-22 17:17:27.126-04,9,6,15
1713,55,2011-08-22 17:17:27.126-04,1,14,15
1714,56,2011-08-22 17:17:27.126-04,5,10,15
1715,57,2011-08-22 17:17:27.126-04,8,3,11
1716,3,2011-08-22 17:18:28.299-04,9,8,17
1717,5,2011-08-22 17:18:28.299-04,3,12,15
1718,6,2011-08-22 17:18:28.299-04,6,9,15
1719,8,2011-08-22 17:18:28.299-04,3,12,15
1720,9,2011-08-22 17:18:28.299-04,7,12,19
1721,10,2011-08-22 17:18:28.299-04,5,14,19
1722,11,2011-08-22 17:18:28.299-04,5,10,15
1723,12,2011-08-22 17:18:28.299-04,8,7,15
1724,13,2011-08-22 17:18:28.299-04,0,14,14
1725,14,2011-08-22 17:18:28.299-04,0,17,17
1726,15,2011-08-22 17:18:28.299-04,5,10,15
1727,16,2011-08-22 17:18:28.299-04,17,2,19
1728,17,2011-08-22 17:18:28.299-04,5,10,15
1729,18,2011-08-22 17:18:28.299-04,5,10,15
1730,20,2011-08-22 17:18:28.299-04,16,3,19
1731,21,2011-08-22 17:18:28.299-04,4,19,23
1732,22,2011-08-22 17:18:28.299-04,18,29,47
1733,23,2011-08-22 17:18:28.299-04,11,7,18
1734,24,2011-08-22 17:18:28.299-04,7,8,15
1735,25,2011-08-22 17:18:28.299-04,6,9,15
1736,26,2011-08-22 17:18:28.299-04,7,8,15
1737,27,2011-08-22 17:18:28.299-04,4,10,14
1738,30,2011-08-22 17:18:28.299-04,7,8,15
1739,31,2011-08-22 17:18:28.299-04,5,6,11
1740,32,2011-08-22 17:18:28.299-04,5,6,11
1741,33,2011-08-22 17:18:28.299-04,4,15,19
1742,34,2011-08-22 17:18:28.299-04,9,6,15
1743,35,2011-08-22 17:18:28.299-04,0,11,11
1744,36,2011-08-22 17:18:28.299-04,0,16,16
1745,37,2011-08-22 17:18:28.299-04,8,7,15
1746,38,2011-08-22 17:18:28.299-04,30,5,35
1747,39,2011-08-22 17:18:28.299-04,9,10,19
1748,40,2011-08-22 17:18:28.299-04,5,8,13
1749,41,2011-08-22 17:18:28.299-04,7,12,19
1750,42,2011-08-22 17:18:28.299-04,2,17,19
1751,43,2011-08-22 17:18:28.299-04,8,7,15
1752,44,2011-08-22 17:18:28.299-04,17,2,19
1753,45,2011-08-22 17:18:28.299-04,9,10,19
1754,46,2011-08-22 17:18:28.299-04,10,9,19
1755,47,2011-08-22 17:18:28.299-04,9,2,11
1756,48,2011-08-22 17:18:28.299-04,0,15,15
1757,49,2011-08-22 17:18:28.299-04,2,13,15
1758,50,2011-08-22 17:18:28.299-04,0,15,15
1759,51,2011-08-22 17:18:28.299-04,7,8,15
1760,52,2011-08-22 17:18:28.299-04,9,5,14
1761,53,2011-08-22 17:18:28.299-04,9,6,15
1762,55,2011-08-22 17:18:28.299-04,1,14,15
1763,56,2011-08-22 17:18:28.299-04,5,10,15
1764,57,2011-08-22 17:18:28.299-04,8,3,11
1765,3,2011-08-22 17:19:29.318-04,9,8,17
1766,5,2011-08-22 17:19:29.318-04,3,12,15
1767,6,2011-08-22 17:19:29.318-04,6,9,15
1768,8,2011-08-22 17:19:29.318-04,3,12,15
1769,9,2011-08-22 17:19:29.318-04,8,11,19
1770,10,2011-08-22 17:19:29.318-04,5,14,19
1771,11,2011-08-22 17:19:29.318-04,5,10,15
1772,12,2011-08-22 17:19:29.318-04,8,7,15
1773,13,2011-08-22 17:19:29.318-04,0,14,14
1774,14,2011-08-22 17:19:29.318-04,0,17,17
1775,15,2011-08-22 17:19:29.318-04,5,10,15
1776,16,2011-08-22 17:19:29.318-04,17,2,19
1777,17,2011-08-22 17:19:29.318-04,5,10,15
1778,18,2011-08-22 17:19:29.318-04,5,10,15
1779,20,2011-08-22 17:19:29.318-04,16,3,19
1780,21,2011-08-22 17:19:29.318-04,4,19,23
1781,22,2011-08-22 17:19:29.318-04,16,31,47
1782,23,2011-08-22 17:19:29.318-04,11,7,18
1783,24,2011-08-22 17:19:29.318-04,5,10,15
1784,25,2011-08-22 17:19:29.318-04,6,9,15
1785,26,2011-08-22 17:19:29.318-04,7,8,15
1786,27,2011-08-22 17:19:29.318-04,3,11,14
1787,30,2011-08-22 17:19:29.318-04,7,8,15
1788,31,2011-08-22 17:19:29.318-04,5,6,11
1789,32,2011-08-22 17:19:29.318-04,5,6,11
1790,33,2011-08-22 17:19:29.318-04,4,15,19
1791,34,2011-08-22 17:19:29.318-04,10,5,15
1792,35,2011-08-22 17:19:29.318-04,0,11,11
1793,36,2011-08-22 17:19:29.318-04,0,16,16
1794,37,2011-08-22 17:19:29.318-04,8,7,15
1795,38,2011-08-22 17:19:29.318-04,30,5,35
1796,39,2011-08-22 17:19:29.318-04,9,10,19
1797,40,2011-08-22 17:19:29.318-04,7,6,13
1798,41,2011-08-22 17:19:29.318-04,7,12,19
1799,42,2011-08-22 17:19:29.318-04,1,18,19
1800,43,2011-08-22 17:19:29.318-04,8,7,15
1801,44,2011-08-22 17:19:29.318-04,17,2,19
1802,45,2011-08-22 17:19:29.318-04,9,10,19
1803,46,2011-08-22 17:19:29.318-04,10,9,19
1804,47,2011-08-22 17:19:29.318-04,9,2,11
1805,48,2011-08-22 17:19:29.318-04,0,15,15
1806,49,2011-08-22 17:19:29.318-04,2,13,15
1807,50,2011-08-22 17:19:29.318-04,0,15,15
1808,51,2011-08-22 17:19:29.318-04,7,8,15
1809,52,2011-08-22 17:19:29.318-04,9,5,14
1810,53,2011-08-22 17:19:29.318-04,9,6,15
1811,55,2011-08-22 17:19:29.318-04,1,14,15
1812,56,2011-08-22 17:19:29.318-04,5,10,15
1813,57,2011-08-22 17:19:29.318-04,8,3,11
1814,3,2011-08-22 17:20:30.304-04,9,8,17
1815,5,2011-08-22 17:20:30.304-04,3,12,15
1816,6,2011-08-22 17:20:30.304-04,6,9,15
1817,8,2011-08-22 17:20:30.304-04,3,12,15
1818,9,2011-08-22 17:20:30.304-04,8,11,19
1819,10,2011-08-22 17:20:30.304-04,5,14,19
1820,11,2011-08-22 17:20:30.304-04,5,10,15
1821,12,2011-08-22 17:20:30.304-04,8,7,15
1822,13,2011-08-22 17:20:30.304-04,0,14,14
1823,14,2011-08-22 17:20:30.304-04,0,17,17
1824,15,2011-08-22 17:20:30.304-04,5,10,15
1825,16,2011-08-22 17:20:30.304-04,17,2,19
1826,17,2011-08-22 17:20:30.304-04,5,10,15
1827,18,2011-08-22 17:20:30.304-04,5,10,15
1828,20,2011-08-22 17:20:30.304-04,16,3,19
1829,21,2011-08-22 17:20:30.304-04,4,19,23
1830,22,2011-08-22 17:20:30.304-04,15,32,47
1831,23,2011-08-22 17:20:30.304-04,10,8,18
1832,24,2011-08-22 17:20:30.304-04,5,10,15
1833,25,2011-08-22 17:20:30.304-04,6,9,15
1834,26,2011-08-22 17:20:30.304-04,7,8,15
1835,27,2011-08-22 17:20:30.304-04,2,12,14
1836,30,2011-08-22 17:20:30.304-04,7,8,15
1837,31,2011-08-22 17:20:30.304-04,5,6,11
1838,32,2011-08-22 17:20:30.304-04,5,6,11
1839,33,2011-08-22 17:20:30.304-04,4,15,19
1840,34,2011-08-22 17:20:30.304-04,10,5,15
1841,35,2011-08-22 17:20:30.304-04,0,11,11
1842,36,2011-08-22 17:20:30.304-04,0,16,16
1843,37,2011-08-22 17:20:30.304-04,8,7,15
1844,38,2011-08-22 17:20:30.304-04,30,5,35
1845,39,2011-08-22 17:20:30.304-04,9,10,19
1846,40,2011-08-22 17:20:30.304-04,7,6,13
1847,41,2011-08-22 17:20:30.304-04,7,12,19
1848,42,2011-08-22 17:20:30.304-04,2,17,19
1849,43,2011-08-22 17:20:30.304-04,8,7,15
1850,44,2011-08-22 17:20:30.304-04,16,3,19
1851,45,2011-08-22 17:20:30.304-04,9,10,19
1852,46,2011-08-22 17:20:30.304-04,10,9,19
1853,47,2011-08-22 17:20:30.304-04,9,2,11
1854,48,2011-08-22 17:20:30.304-04,0,15,15
1855,49,2011-08-22 17:20:30.304-04,2,13,15
1856,50,2011-08-22 17:20:30.304-04,1,14,15
1857,51,2011-08-22 17:20:30.304-04,7,8,15
1858,52,2011-08-22 17:20:30.304-04,9,5,14
1859,53,2011-08-22 17:20:30.304-04,9,6,15
1860,55,2011-08-22 17:20:30.304-04,1,14,15
1861,56,2011-08-22 17:20:30.304-04,5,10,15
1862,57,2011-08-22 17:20:30.304-04,8,3,11
1863,3,2011-08-22 17:21:31.262-04,9,8,17
1864,5,2011-08-22 17:21:31.262-04,4,11,15
1865,6,2011-08-22 17:21:31.262-04,6,9,15
1866,8,2011-08-22 17:21:31.262-04,3,12,15
1867,9,2011-08-22 17:21:31.262-04,8,11,19
1868,10,2011-08-22 17:21:31.262-04,5,14,19
1869,11,2011-08-22 17:21:31.262-04,5,10,15
1870,12,2011-08-22 17:21:31.262-04,8,7,15
1871,13,2011-08-22 17:21:31.262-04,0,14,14
1872,14,2011-08-22 17:21:31.262-04,0,17,17
1873,15,2011-08-22 17:21:31.262-04,5,10,15
1874,16,2011-08-22 17:21:31.262-04,16,3,19
1875,17,2011-08-22 17:21:31.262-04,5,10,15
1876,18,2011-08-22 17:21:31.262-04,5,10,15
1877,20,2011-08-22 17:21:31.262-04,16,3,19
1878,21,2011-08-22 17:21:31.262-04,4,19,23
1879,22,2011-08-22 17:21:31.262-04,15,32,47
1880,23,2011-08-22 17:21:31.262-04,10,8,18
1881,24,2011-08-22 17:21:31.262-04,5,10,15
1882,25,2011-08-22 17:21:31.262-04,6,9,15
1883,26,2011-08-22 17:21:31.262-04,7,8,15
1884,27,2011-08-22 17:21:31.262-04,3,11,14
1885,30,2011-08-22 17:21:31.262-04,7,8,15
1886,31,2011-08-22 17:21:31.262-04,5,6,11
1887,32,2011-08-22 17:21:31.262-04,5,6,11
1888,33,2011-08-22 17:21:31.262-04,4,15,19
1889,34,2011-08-22 17:21:31.262-04,10,5,15
1890,35,2011-08-22 17:21:31.262-04,0,11,11
1891,36,2011-08-22 17:21:31.262-04,0,16,16
1892,37,2011-08-22 17:21:31.262-04,8,7,15
1893,38,2011-08-22 17:21:31.262-04,30,5,35
1894,39,2011-08-22 17:21:31.262-04,9,10,19
1895,40,2011-08-22 17:21:31.262-04,7,6,13
1896,41,2011-08-22 17:21:31.262-04,7,12,19
1897,42,2011-08-22 17:21:31.262-04,3,16,19
1898,43,2011-08-22 17:21:31.262-04,8,7,15
1899,44,2011-08-22 17:21:31.262-04,16,3,19
1900,45,2011-08-22 17:21:31.262-04,9,10,19
1901,46,2011-08-22 17:21:31.262-04,11,8,19
1902,47,2011-08-22 17:21:31.262-04,9,2,11
1903,48,2011-08-22 17:21:31.262-04,0,15,15
1904,49,2011-08-22 17:21:31.262-04,2,13,15
1905,50,2011-08-22 17:21:31.262-04,1,14,15
1906,51,2011-08-22 17:21:31.262-04,7,8,15
1907,52,2011-08-22 17:21:31.262-04,9,5,14
1908,53,2011-08-22 17:21:31.262-04,9,6,15
1909,55,2011-08-22 17:21:31.262-04,0,15,15
1910,56,2011-08-22 17:21:31.262-04,5,10,15
1911,57,2011-08-22 17:21:31.262-04,8,3,11
1912,3,2011-08-22 17:22:32.311-04,9,8,17
1913,5,2011-08-22 17:22:32.311-04,4,11,15
1914,6,2011-08-22 17:22:32.311-04,5,10,15
1915,8,2011-08-22 17:22:32.311-04,3,12,15
1916,9,2011-08-22 17:22:32.311-04,8,11,19
1917,10,2011-08-22 17:22:32.311-04,5,14,19
1918,11,2011-08-22 17:22:32.311-04,5,10,15
1919,12,2011-08-22 17:22:32.311-04,8,7,15
1920,13,2011-08-22 17:22:32.311-04,0,14,14
1921,14,2011-08-22 17:22:32.311-04,0,17,17
1922,15,2011-08-22 17:22:32.311-04,5,10,15
1923,16,2011-08-22 17:22:32.311-04,16,3,19
1924,17,2011-08-22 17:22:32.311-04,5,10,15
1925,18,2011-08-22 17:22:32.311-04,5,10,15
1926,20,2011-08-22 17:22:32.311-04,16,3,19
1927,21,2011-08-22 17:22:32.311-04,4,19,23
1928,22,2011-08-22 17:22:32.311-04,15,32,47
1929,23,2011-08-22 17:22:32.311-04,10,8,18
1930,24,2011-08-22 17:22:32.311-04,5,10,15
1931,25,2011-08-22 17:22:32.311-04,6,9,15
1932,26,2011-08-22 17:22:32.311-04,7,8,15
1933,27,2011-08-22 17:22:32.311-04,3,11,14
1934,30,2011-08-22 17:22:32.311-04,7,8,15
1935,31,2011-08-22 17:22:32.311-04,5,6,11
1936,32,2011-08-22 17:22:32.311-04,5,6,11
1937,33,2011-08-22 17:22:32.311-04,4,15,19
1938,34,2011-08-22 17:22:32.311-04,10,5,15
1939,35,2011-08-22 17:22:32.311-04,0,11,11
1940,36,2011-08-22 17:22:32.311-04,0,16,16
1941,37,2011-08-22 17:22:32.311-04,8,7,15
1942,38,2011-08-22 17:22:32.311-04,29,6,35
1943,39,2011-08-22 17:22:32.311-04,9,10,19
1944,40,2011-08-22 17:22:32.311-04,8,5,13
1945,41,2011-08-22 17:22:32.311-04,5,14,19
1946,42,2011-08-22 17:22:32.311-04,3,16,19
1947,43,2011-08-22 17:22:32.311-04,8,7,15
1948,44,2011-08-22 17:22:32.311-04,16,3,19
1949,45,2011-08-22 17:22:32.311-04,9,10,19
1950,46,2011-08-22 17:22:32.311-04,11,8,19
1951,47,2011-08-22 17:22:32.311-04,9,2,11
1952,48,2011-08-22 17:22:32.311-04,0,15,15
1953,49,2011-08-22 17:22:32.311-04,2,13,15
1954,50,2011-08-22 17:22:32.311-04,1,14,15
1955,51,2011-08-22 17:22:32.311-04,7,8,15
1956,52,2011-08-22 17:22:32.311-04,8,6,14
1957,53,2011-08-22 17:22:32.311-04,9,6,15
1958,55,2011-08-22 17:22:32.311-04,0,15,15
1959,56,2011-08-22 17:22:32.311-04,5,10,15
1960,57,2011-08-22 17:22:32.311-04,8,3,11
1961,3,2011-08-22 17:23:33.32-04,9,8,17
1962,5,2011-08-22 17:23:33.32-04,4,11,15
1963,6,2011-08-22 17:23:33.32-04,5,10,15
1964,8,2011-08-22 17:23:33.32-04,3,12,15
1965,9,2011-08-22 17:23:33.32-04,8,11,19
1966,10,2011-08-22 17:23:33.32-04,5,14,19
1967,11,2011-08-22 17:23:33.32-04,5,10,15
1968,12,2011-08-22 17:23:33.32-04,8,7,15
1969,13,2011-08-22 17:23:33.32-04,0,14,14
1970,14,2011-08-22 17:23:33.32-04,0,17,17
1971,15,2011-08-22 17:23:33.32-04,5,10,15
1972,16,2011-08-22 17:23:33.32-04,16,3,19
1973,17,2011-08-22 17:23:33.32-04,5,10,15
1974,18,2011-08-22 17:23:33.32-04,5,10,15
1975,20,2011-08-22 17:23:33.32-04,16,3,19
1976,21,2011-08-22 17:23:33.32-04,4,19,23
1977,22,2011-08-22 17:23:33.32-04,13,34,47
1978,23,2011-08-22 17:23:33.32-04,10,8,18
1979,24,2011-08-22 17:23:33.32-04,5,10,15
1980,25,2011-08-22 17:23:33.32-04,6,9,15
1981,26,2011-08-22 17:23:33.32-04,7,8,15
1982,27,2011-08-22 17:23:33.32-04,3,11,14
1983,30,2011-08-22 17:23:33.32-04,7,8,15
1984,31,2011-08-22 17:23:33.32-04,5,6,11
1985,32,2011-08-22 17:23:33.32-04,5,6,11
1986,33,2011-08-22 17:23:33.32-04,4,15,19
1987,34,2011-08-22 17:23:33.32-04,10,5,15
1988,35,2011-08-22 17:23:33.32-04,0,11,11
1989,36,2011-08-22 17:23:33.32-04,0,16,16
1990,37,2011-08-22 17:23:33.32-04,8,7,15
1991,38,2011-08-22 17:23:33.32-04,29,6,35
1992,39,2011-08-22 17:23:33.32-04,10,9,19
1993,40,2011-08-22 17:23:33.32-04,8,5,13
1994,41,2011-08-22 17:23:33.32-04,5,14,19
1995,42,2011-08-22 17:23:33.32-04,3,16,19
1996,43,2011-08-22 17:23:33.32-04,7,8,15
1997,44,2011-08-22 17:23:33.32-04,15,4,19
1998,45,2011-08-22 17:23:33.32-04,9,10,19
1999,46,2011-08-22 17:23:33.32-04,11,8,19
2000,47,2011-08-22 17:23:33.32-04,9,2,11
2001,48,2011-08-22 17:23:33.32-04,0,15,15
2002,49,2011-08-22 17:23:33.32-04,2,13,15
2003,50,2011-08-22 17:23:33.32-04,1,14,15
2004,51,2011-08-22 17:23:33.32-04,7,8,15
2005,52,2011-08-22 17:23:33.32-04,9,5,14
2006,53,2011-08-22 17:23:33.32-04,9,6,15
2007,55,2011-08-22 17:23:33.32-04,0,15,15
2008,56,2011-08-22 17:23:33.32-04,5,10,15
2009,57,2011-08-22 17:23:33.32-04,8,3,11
2010,3,2011-08-22 17:24:34.256-04,9,8,17
2011,5,2011-08-22 17:24:34.256-04,4,11,15
2012,6,2011-08-22 17:24:34.256-04,4,11,15
2013,8,2011-08-22 17:24:34.256-04,3,12,15
2014,9,2011-08-22 17:24:34.256-04,8,11,19
2015,10,2011-08-22 17:24:34.256-04,5,14,19
2016,11,2011-08-22 17:24:34.256-04,5,10,15
2017,12,2011-08-22 17:24:34.256-04,8,7,15
2018,13,2011-08-22 17:24:34.256-04,0,14,14
2019,14,2011-08-22 17:24:34.256-04,0,17,17
2020,15,2011-08-22 17:24:34.256-04,4,11,15
2021,16,2011-08-22 17:24:34.256-04,16,3,19
2022,17,2011-08-22 17:24:34.256-04,5,10,15
2023,18,2011-08-22 17:24:34.256-04,5,10,15
2024,20,2011-08-22 17:24:34.256-04,16,3,19
2025,21,2011-08-22 17:24:34.256-04,4,19,23
2026,22,2011-08-22 17:24:34.256-04,13,34,47
2027,23,2011-08-22 17:24:34.256-04,10,8,18
2028,24,2011-08-22 17:24:34.256-04,5,10,15
2029,25,2011-08-22 17:24:34.256-04,6,9,15
2030,26,2011-08-22 17:24:34.256-04,7,8,15
2031,27,2011-08-22 17:24:34.256-04,3,11,14
2032,30,2011-08-22 17:24:34.256-04,7,8,15
2033,31,2011-08-22 17:24:34.256-04,5,6,11
2034,32,2011-08-22 17:24:34.256-04,5,6,11
2035,33,2011-08-22 17:24:34.256-04,4,15,19
2036,34,2011-08-22 17:24:34.256-04,10,5,15
2037,35,2011-08-22 17:24:34.256-04,0,11,11
2038,36,2011-08-22 17:24:34.256-04,0,16,16
2039,37,2011-08-22 17:24:34.256-04,8,7,15
2040,38,2011-08-22 17:24:34.256-04,29,6,35
2041,39,2011-08-22 17:24:34.256-04,10,9,19
2042,40,2011-08-22 17:24:34.256-04,8,5,13
2043,41,2011-08-22 17:24:34.256-04,5,14,19
2044,42,2011-08-22 17:24:34.256-04,3,16,19
2045,43,2011-08-22 17:24:34.256-04,7,8,15
2046,44,2011-08-22 17:24:34.256-04,15,4,19
2047,45,2011-08-22 17:24:34.256-04,9,10,19
2048,46,2011-08-22 17:24:34.256-04,11,8,19
2049,47,2011-08-22 17:24:34.256-04,9,2,11
2050,48,2011-08-22 17:24:34.256-04,0,15,15
2051,49,2011-08-22 17:24:34.256-04,2,13,15
2052,50,2011-08-22 17:24:34.256-04,0,15,15
2053,51,2011-08-22 17:24:34.256-04,6,9,15
2054,52,2011-08-22 17:24:34.256-04,9,5,14
2055,53,2011-08-22 17:24:34.256-04,9,6,15
2056,55,2011-08-22 17:24:34.256-04,0,15,15
2057,56,2011-08-22 17:24:34.256-04,5,10,15
2058,57,2011-08-22 17:24:34.256-04,8,3,11
2059,3,2011-08-22 17:25:35.227-04,9,8,17
2060,5,2011-08-22 17:25:35.227-04,4,11,15
2061,6,2011-08-22 17:25:35.227-04,4,11,15
2062,8,2011-08-22 17:25:35.227-04,3,12,15
2063,9,2011-08-22 17:25:35.227-04,7,12,19
2064,10,2011-08-22 17:25:35.227-04,5,14,19
2065,11,2011-08-22 17:25:35.227-04,5,10,15
2066,12,2011-08-22 17:25:35.227-04,8,7,15
2067,13,2011-08-22 17:25:35.227-04,0,14,14
2068,14,2011-08-22 17:25:35.227-04,0,17,17
2069,15,2011-08-22 17:25:35.227-04,3,12,15
2070,16,2011-08-22 17:25:35.227-04,16,3,19
2071,17,2011-08-22 17:25:35.227-04,5,10,15
2072,18,2011-08-22 17:25:35.227-04,5,10,15
2073,20,2011-08-22 17:25:35.227-04,16,3,19
2074,21,2011-08-22 17:25:35.227-04,5,18,23
2075,22,2011-08-22 17:25:35.227-04,13,34,47
2076,23,2011-08-22 17:25:35.227-04,10,8,18
2077,24,2011-08-22 17:25:35.227-04,3,12,15
2078,25,2011-08-22 17:25:35.227-04,6,9,15
2079,26,2011-08-22 17:25:35.227-04,7,8,15
2080,27,2011-08-22 17:25:35.227-04,3,11,14
2081,30,2011-08-22 17:25:35.227-04,7,8,15
2082,31,2011-08-22 17:25:35.227-04,5,6,11
2083,32,2011-08-22 17:25:35.227-04,5,6,11
2084,33,2011-08-22 17:25:35.227-04,4,15,19
2085,34,2011-08-22 17:25:35.227-04,10,5,15
2086,35,2011-08-22 17:25:35.227-04,0,11,11
2087,36,2011-08-22 17:25:35.227-04,0,16,16
2088,37,2011-08-22 17:25:35.227-04,8,7,15
2089,38,2011-08-22 17:25:35.227-04,31,4,35
2090,39,2011-08-22 17:25:35.227-04,10,9,19
2091,40,2011-08-22 17:25:35.227-04,8,5,13
2092,41,2011-08-22 17:25:35.227-04,5,14,19
2093,42,2011-08-22 17:25:35.227-04,3,16,19
2094,43,2011-08-22 17:25:35.227-04,7,8,15
2095,44,2011-08-22 17:25:35.227-04,15,4,19
2096,45,2011-08-22 17:25:35.227-04,9,10,19
2097,46,2011-08-22 17:25:35.227-04,11,8,19
2098,47,2011-08-22 17:25:35.227-04,9,2,11
2099,48,2011-08-22 17:25:35.227-04,0,15,15
2100,49,2011-08-22 17:25:35.227-04,2,13,15
2101,50,2011-08-22 17:25:35.227-04,0,15,15
2102,51,2011-08-22 17:25:35.227-04,6,9,15
2103,52,2011-08-22 17:25:35.227-04,9,5,14
2104,53,2011-08-22 17:25:35.227-04,9,6,15
2105,55,2011-08-22 17:25:35.227-04,0,15,15
2106,56,2011-08-22 17:25:35.227-04,4,11,15
2107,57,2011-08-22 17:25:35.227-04,8,3,11
2108,3,2011-08-22 17:26:36.209-04,9,8,17
2109,5,2011-08-22 17:26:36.209-04,4,11,15
2110,6,2011-08-22 17:26:36.209-04,4,11,15
2111,8,2011-08-22 17:26:36.209-04,3,12,15
2112,9,2011-08-22 17:26:36.209-04,6,13,19
2113,10,2011-08-22 17:26:36.209-04,5,14,19
2114,11,2011-08-22 17:26:36.209-04,5,10,15
2115,12,2011-08-22 17:26:36.209-04,8,7,15
2116,13,2011-08-22 17:26:36.209-04,0,14,14
2117,14,2011-08-22 17:26:36.209-04,0,17,17
2118,15,2011-08-22 17:26:36.209-04,3,12,15
2119,16,2011-08-22 17:26:36.209-04,16,3,19
2120,17,2011-08-22 17:26:36.209-04,5,10,15
2121,18,2011-08-22 17:26:36.209-04,5,10,15
2122,20,2011-08-22 17:26:36.209-04,16,3,19
2123,21,2011-08-22 17:26:36.209-04,4,19,23
2124,22,2011-08-22 17:26:36.209-04,13,34,47
2125,23,2011-08-22 17:26:36.209-04,10,8,18
2126,24,2011-08-22 17:26:36.209-04,3,12,15
2127,25,2011-08-22 17:26:36.209-04,6,9,15
2128,26,2011-08-22 17:26:36.209-04,7,8,15
2129,27,2011-08-22 17:26:36.209-04,3,11,14
2130,30,2011-08-22 17:26:36.209-04,7,8,15
2131,31,2011-08-22 17:26:36.209-04,5,6,11
2132,32,2011-08-22 17:26:36.209-04,6,5,11
2133,33,2011-08-22 17:26:36.209-04,4,15,19
2134,34,2011-08-22 17:26:36.209-04,10,5,15
2135,35,2011-08-22 17:26:36.209-04,0,11,11
2136,36,2011-08-22 17:26:36.209-04,0,16,16
2137,37,2011-08-22 17:26:36.209-04,8,7,15
2138,38,2011-08-22 17:26:36.209-04,31,4,35
2139,39,2011-08-22 17:26:36.209-04,10,9,19
2140,40,2011-08-22 17:26:36.209-04,8,5,13
2141,41,2011-08-22 17:26:36.209-04,5,14,19
2142,42,2011-08-22 17:26:36.209-04,2,17,19
2143,43,2011-08-22 17:26:36.209-04,7,8,15
2144,44,2011-08-22 17:26:36.209-04,15,4,19
2145,45,2011-08-22 17:26:36.209-04,9,10,19
2146,46,2011-08-22 17:26:36.209-04,11,8,19
2147,47,2011-08-22 17:26:36.209-04,9,2,11
2148,48,2011-08-22 17:26:36.209-04,0,15,15
2149,49,2011-08-22 17:26:36.209-04,2,13,15
2150,50,2011-08-22 17:26:36.209-04,0,15,15
2151,51,2011-08-22 17:26:36.209-04,6,9,15
2152,52,2011-08-22 17:26:36.209-04,10,4,14
2153,53,2011-08-22 17:26:36.209-04,9,6,15
2154,55,2011-08-22 17:26:36.209-04,0,15,15
2155,56,2011-08-22 17:26:36.209-04,4,11,15
2156,57,2011-08-22 17:26:36.209-04,8,3,11
2157,3,2011-08-22 17:27:37.153-04,9,8,17
2158,5,2011-08-22 17:27:37.153-04,4,11,15
2159,6,2011-08-22 17:27:37.153-04,5,10,15
2160,8,2011-08-22 17:27:37.153-04,3,12,15
2161,9,2011-08-22 17:27:37.153-04,6,13,19
2162,10,2011-08-22 17:27:37.153-04,5,14,19
2163,11,2011-08-22 17:27:37.153-04,5,10,15
2164,12,2011-08-22 17:27:37.153-04,8,7,15
2165,13,2011-08-22 17:27:37.153-04,0,14,14
2166,14,2011-08-22 17:27:37.153-04,0,17,17
2167,15,2011-08-22 17:27:37.153-04,3,12,15
2168,16,2011-08-22 17:27:37.153-04,16,3,19
2169,17,2011-08-22 17:27:37.153-04,5,10,15
2170,18,2011-08-22 17:27:37.153-04,5,10,15
2171,20,2011-08-22 17:27:37.153-04,16,3,19
2172,21,2011-08-22 17:27:37.153-04,3,20,23
2173,22,2011-08-22 17:27:37.153-04,14,33,47
2174,23,2011-08-22 17:27:37.153-04,10,8,18
2175,24,2011-08-22 17:27:37.153-04,3,12,15
2176,25,2011-08-22 17:27:37.153-04,6,9,15
2177,26,2011-08-22 17:27:37.153-04,7,8,15
2178,27,2011-08-22 17:27:37.153-04,3,11,14
2179,30,2011-08-22 17:27:37.153-04,7,8,15
2180,31,2011-08-22 17:27:37.153-04,5,6,11
2181,32,2011-08-22 17:27:37.153-04,7,4,11
2182,33,2011-08-22 17:27:37.153-04,4,15,19
2183,34,2011-08-22 17:27:37.153-04,10,5,15
2184,35,2011-08-22 17:27:37.153-04,0,11,11
2185,36,2011-08-22 17:27:37.153-04,1,15,16
2186,37,2011-08-22 17:27:37.153-04,8,7,15
2187,38,2011-08-22 17:27:37.153-04,31,4,35
2188,39,2011-08-22 17:27:37.153-04,10,9,19
2189,40,2011-08-22 17:27:37.153-04,8,5,13
2190,41,2011-08-22 17:27:37.153-04,5,14,19
2191,42,2011-08-22 17:27:37.153-04,0,19,19
2192,43,2011-08-22 17:27:37.153-04,7,8,15
2193,44,2011-08-22 17:27:37.153-04,16,3,19
2194,45,2011-08-22 17:27:37.153-04,10,9,19
2195,46,2011-08-22 17:27:37.153-04,11,8,19
2196,47,2011-08-22 17:27:37.153-04,9,2,11
2197,48,2011-08-22 17:27:37.153-04,0,15,15
2198,49,2011-08-22 17:27:37.153-04,1,14,15
2199,50,2011-08-22 17:27:37.153-04,0,15,15
2200,51,2011-08-22 17:27:37.153-04,7,8,15
2201,52,2011-08-22 17:27:37.153-04,10,4,14
2202,53,2011-08-22 17:27:37.153-04,9,6,15
2203,55,2011-08-22 17:27:37.153-04,0,15,15
2204,56,2011-08-22 17:27:37.153-04,4,11,15
2205,57,2011-08-22 17:27:37.153-04,8,3,11
2206,3,2011-08-22 17:28:38.161-04,9,8,17
2207,5,2011-08-22 17:28:38.161-04,4,11,15
2208,6,2011-08-22 17:28:38.161-04,5,10,15
2209,8,2011-08-22 17:28:38.161-04,3,12,15
2210,9,2011-08-22 17:28:38.161-04,6,13,19
2211,10,2011-08-22 17:28:38.161-04,5,14,19
2212,11,2011-08-22 17:28:38.161-04,4,11,15
2213,12,2011-08-22 17:28:38.161-04,8,7,15
2214,13,2011-08-22 17:28:38.161-04,1,13,14
2215,14,2011-08-22 17:28:38.161-04,0,17,17
2216,15,2011-08-22 17:28:38.161-04,3,12,15
2217,16,2011-08-22 17:28:38.161-04,15,4,19
2218,17,2011-08-22 17:28:38.161-04,5,10,15
2219,18,2011-08-22 17:28:38.161-04,5,10,15
2220,20,2011-08-22 17:28:38.161-04,16,3,19
2221,21,2011-08-22 17:28:38.161-04,3,20,23
2222,22,2011-08-22 17:28:38.161-04,15,32,47
2223,23,2011-08-22 17:28:38.161-04,10,8,18
2224,24,2011-08-22 17:28:38.161-04,3,12,15
2225,25,2011-08-22 17:28:38.161-04,6,9,15
2226,26,2011-08-22 17:28:38.161-04,7,8,15
2227,27,2011-08-22 17:28:38.161-04,3,11,14
2228,30,2011-08-22 17:28:38.161-04,7,8,15
2229,31,2011-08-22 17:28:38.161-04,5,6,11
2230,32,2011-08-22 17:28:38.161-04,7,4,11
2231,33,2011-08-22 17:28:38.161-04,3,16,19
2232,34,2011-08-22 17:28:38.161-04,10,5,15
2233,35,2011-08-22 17:28:38.161-04,0,11,11
2234,36,2011-08-22 17:28:38.161-04,1,15,16
2235,37,2011-08-22 17:28:38.161-04,8,7,15
2236,38,2011-08-22 17:28:38.161-04,31,4,35
2237,39,2011-08-22 17:28:38.161-04,10,9,19
2238,40,2011-08-22 17:28:38.161-04,8,5,13
2239,41,2011-08-22 17:28:38.161-04,5,14,19
2240,42,2011-08-22 17:28:38.161-04,0,19,19
2241,43,2011-08-22 17:28:38.161-04,7,8,15
2242,44,2011-08-22 17:28:38.161-04,16,3,19
2243,45,2011-08-22 17:28:38.161-04,10,9,19
2244,46,2011-08-22 17:28:38.161-04,11,8,19
2245,47,2011-08-22 17:28:38.161-04,9,2,11
2246,48,2011-08-22 17:28:38.161-04,0,15,15
2247,49,2011-08-22 17:28:38.161-04,1,14,15
2248,50,2011-08-22 17:28:38.161-04,0,15,15
2249,51,2011-08-22 17:28:38.161-04,7,8,15
2250,52,2011-08-22 17:28:38.161-04,10,4,14
2251,53,2011-08-22 17:28:38.161-04,9,6,15
2252,55,2011-08-22 17:28:38.161-04,0,15,15
2253,56,2011-08-22 17:28:38.161-04,4,11,15
2254,57,2011-08-22 17:28:38.161-04,8,3,11
2255,3,2011-08-22 17:29:38.977-04,9,8,17
2256,5,2011-08-22 17:29:38.977-04,4,11,15
2257,6,2011-08-22 17:29:38.977-04,7,8,15
2258,8,2011-08-22 17:29:38.977-04,3,12,15
2259,9,2011-08-22 17:29:38.977-04,6,13,19
2260,10,2011-08-22 17:29:38.977-04,5,14,19
2261,11,2011-08-22 17:29:38.977-04,4,11,15
2262,12,2011-08-22 17:29:38.977-04,8,7,15
2263,13,2011-08-22 17:29:38.977-04,1,13,14
2264,14,2011-08-22 17:29:38.977-04,0,17,17
2265,15,2011-08-22 17:29:38.977-04,3,12,15
2266,16,2011-08-22 17:29:38.977-04,15,4,19
2267,17,2011-08-22 17:29:38.977-04,5,10,15
2268,18,2011-08-22 17:29:38.977-04,5,10,15
2269,20,2011-08-22 17:29:38.977-04,16,3,19
2270,21,2011-08-22 17:29:38.977-04,3,20,23
2271,22,2011-08-22 17:29:38.977-04,15,32,47
2272,23,2011-08-22 17:29:38.977-04,10,8,18
2273,24,2011-08-22 17:29:38.977-04,3,12,15
2274,25,2011-08-22 17:29:38.977-04,6,9,15
2275,26,2011-08-22 17:29:38.977-04,7,8,15
2276,27,2011-08-22 17:29:38.977-04,3,11,14
2277,30,2011-08-22 17:29:38.977-04,7,8,15
2278,31,2011-08-22 17:29:38.977-04,5,6,11
2279,32,2011-08-22 17:29:38.977-04,7,4,11
2280,33,2011-08-22 17:29:38.977-04,3,16,19
2281,34,2011-08-22 17:29:38.977-04,10,5,15
2282,35,2011-08-22 17:29:38.977-04,0,11,11
2283,36,2011-08-22 17:29:38.977-04,1,15,16
2284,37,2011-08-22 17:29:38.977-04,8,7,15
2285,38,2011-08-22 17:29:38.977-04,32,3,35
2286,39,2011-08-22 17:29:38.977-04,9,10,19
2287,40,2011-08-22 17:29:38.977-04,8,5,13
2288,41,2011-08-22 17:29:38.977-04,5,14,19
2289,42,2011-08-22 17:29:38.977-04,0,19,19
2290,43,2011-08-22 17:29:38.977-04,7,8,15
2291,44,2011-08-22 17:29:38.977-04,16,3,19
2292,45,2011-08-22 17:29:38.977-04,10,9,19
2293,46,2011-08-22 17:29:38.977-04,11,8,19
2294,47,2011-08-22 17:29:38.977-04,9,2,11
2295,48,2011-08-22 17:29:38.977-04,0,15,15
2296,49,2011-08-22 17:29:38.977-04,1,14,15
2297,50,2011-08-22 17:29:38.977-04,0,15,15
2298,51,2011-08-22 17:29:38.977-04,7,8,15
2299,52,2011-08-22 17:29:38.977-04,10,4,14
2300,53,2011-08-22 17:29:38.977-04,9,6,15
2301,55,2011-08-22 17:29:38.977-04,0,15,15
2302,56,2011-08-22 17:29:38.977-04,4,11,15
2303,57,2011-08-22 17:29:38.977-04,8,3,11
2304,3,2011-08-22 17:30:39.992-04,9,8,17
2305,5,2011-08-22 17:30:39.992-04,4,11,15
2306,6,2011-08-22 17:30:39.992-04,7,8,15
2307,8,2011-08-22 17:30:39.992-04,3,12,15
2308,9,2011-08-22 17:30:39.992-04,6,13,19
2309,10,2011-08-22 17:30:39.992-04,5,14,19
2310,11,2011-08-22 17:30:39.992-04,4,11,15
2311,12,2011-08-22 17:30:39.992-04,8,7,15
2312,13,2011-08-22 17:30:39.992-04,1,13,14
2313,14,2011-08-22 17:30:39.992-04,0,17,17
2314,15,2011-08-22 17:30:39.992-04,3,12,15
2315,16,2011-08-22 17:30:39.992-04,15,4,19
2316,17,2011-08-22 17:30:39.992-04,5,10,15
2317,18,2011-08-22 17:30:39.992-04,5,10,15
2318,20,2011-08-22 17:30:39.992-04,16,3,19
2319,21,2011-08-22 17:30:39.992-04,3,20,23
2320,22,2011-08-22 17:30:39.992-04,15,32,47
2321,23,2011-08-22 17:30:39.992-04,10,8,18
2322,24,2011-08-22 17:30:39.992-04,3,12,15
2323,25,2011-08-22 17:30:39.992-04,6,9,15
2324,26,2011-08-22 17:30:39.992-04,7,8,15
2325,27,2011-08-22 17:30:39.992-04,3,11,14
2326,30,2011-08-22 17:30:39.992-04,7,8,15
2327,31,2011-08-22 17:30:39.992-04,3,8,11
2328,32,2011-08-22 17:30:39.992-04,7,4,11
2329,33,2011-08-22 17:30:39.992-04,3,16,19
2330,34,2011-08-22 17:30:39.992-04,10,5,15
2331,35,2011-08-22 17:30:39.992-04,0,11,11
2332,36,2011-08-22 17:30:39.992-04,1,15,16
2333,37,2011-08-22 17:30:39.992-04,8,7,15
2334,38,2011-08-22 17:30:39.992-04,33,2,35
2335,39,2011-08-22 17:30:39.992-04,9,10,19
2336,40,2011-08-22 17:30:39.992-04,8,5,13
2337,41,2011-08-22 17:30:39.992-04,5,14,19
2338,42,2011-08-22 17:30:39.992-04,1,18,19
2339,43,2011-08-22 17:30:39.992-04,7,8,15
2340,44,2011-08-22 17:30:39.992-04,17,2,19
2341,45,2011-08-22 17:30:39.992-04,10,9,19
2342,46,2011-08-22 17:30:39.992-04,11,8,19
2343,47,2011-08-22 17:30:39.992-04,9,2,11
2344,48,2011-08-22 17:30:39.992-04,0,15,15
2345,49,2011-08-22 17:30:39.992-04,1,14,15
2346,50,2011-08-22 17:30:39.992-04,0,15,15
2347,51,2011-08-22 17:30:39.992-04,7,8,15
2348,52,2011-08-22 17:30:39.992-04,9,5,14
2349,53,2011-08-22 17:30:39.992-04,9,6,15
2350,55,2011-08-22 17:30:39.992-04,0,15,15
2351,56,2011-08-22 17:30:39.992-04,4,11,15
2352,57,2011-08-22 17:30:39.992-04,8,3,11
2353,3,2011-08-22 17:31:40.932-04,9,8,17
2354,5,2011-08-22 17:31:40.932-04,4,11,15
2355,6,2011-08-22 17:31:40.932-04,7,8,15
2356,8,2011-08-22 17:31:40.932-04,3,12,15
2357,9,2011-08-22 17:31:40.932-04,5,14,19
2358,10,2011-08-22 17:31:40.932-04,5,14,19
2359,11,2011-08-22 17:31:40.932-04,4,11,15
2360,12,2011-08-22 17:31:40.932-04,8,7,15
2361,13,2011-08-22 17:31:40.932-04,1,13,14
2362,14,2011-08-22 17:31:40.932-04,0,17,17
2363,15,2011-08-22 17:31:40.932-04,4,11,15
2364,16,2011-08-22 17:31:40.932-04,15,4,19
2365,17,2011-08-22 17:31:40.932-04,4,11,15
2366,18,2011-08-22 17:31:40.932-04,5,10,15
2367,20,2011-08-22 17:31:40.932-04,16,3,19
2368,21,2011-08-22 17:31:40.932-04,3,20,23
2369,22,2011-08-22 17:31:40.932-04,15,32,47
2370,23,2011-08-22 17:31:40.932-04,10,8,18
2371,24,2011-08-22 17:31:40.932-04,3,12,15
2372,25,2011-08-22 17:31:40.932-04,6,9,15
2373,26,2011-08-22 17:31:40.932-04,7,8,15
2374,27,2011-08-22 17:31:40.932-04,3,11,14
2375,30,2011-08-22 17:31:40.932-04,7,8,15
2376,31,2011-08-22 17:31:40.932-04,3,8,11
2377,32,2011-08-22 17:31:40.932-04,7,4,11
2378,33,2011-08-22 17:31:40.932-04,3,16,19
2379,34,2011-08-22 17:31:40.932-04,10,5,15
2380,35,2011-08-22 17:31:40.932-04,0,11,11
2381,36,2011-08-22 17:31:40.932-04,1,15,16
2382,37,2011-08-22 17:31:40.932-04,8,7,15
2383,38,2011-08-22 17:31:40.932-04,35,0,35
2384,39,2011-08-22 17:31:40.932-04,9,10,19
2385,40,2011-08-22 17:31:40.932-04,8,5,13
2386,41,2011-08-22 17:31:40.932-04,5,14,19
2387,42,2011-08-22 17:31:40.932-04,0,19,19
2388,43,2011-08-22 17:31:40.932-04,6,9,15
2389,44,2011-08-22 17:31:40.932-04,17,2,19
2390,45,2011-08-22 17:31:40.932-04,9,10,19
2391,46,2011-08-22 17:31:40.932-04,11,8,19
2392,47,2011-08-22 17:31:40.932-04,9,2,11
2393,48,2011-08-22 17:31:40.932-04,0,15,15
2394,49,2011-08-22 17:31:40.932-04,4,11,15
2395,50,2011-08-22 17:31:40.932-04,0,15,15
2396,51,2011-08-22 17:31:40.932-04,7,8,15
2397,52,2011-08-22 17:31:40.932-04,9,5,14
2398,53,2011-08-22 17:31:40.932-04,9,6,15
2399,55,2011-08-22 17:31:40.932-04,0,15,15
2400,56,2011-08-22 17:31:40.932-04,4,11,15
2401,57,2011-08-22 17:31:40.932-04,8,3,11
2402,3,2011-08-22 17:32:41.986-04,10,7,17
2403,5,2011-08-22 17:32:41.986-04,4,11,15
2404,6,2011-08-22 17:32:41.986-04,8,7,15
2405,8,2011-08-22 17:32:41.986-04,3,12,15
2406,9,2011-08-22 17:32:41.986-04,5,14,19
2407,10,2011-08-22 17:32:41.986-04,5,14,19
2408,11,2011-08-22 17:32:41.986-04,4,11,15
2409,12,2011-08-22 17:32:41.986-04,8,7,15
2410,13,2011-08-22 17:32:41.986-04,1,13,14
2411,14,2011-08-22 17:32:41.986-04,0,17,17
2412,15,2011-08-22 17:32:41.986-04,4,11,15
2413,16,2011-08-22 17:32:41.986-04,15,4,19
2414,17,2011-08-22 17:32:41.986-04,4,11,15
2415,18,2011-08-22 17:32:41.986-04,5,10,15
2416,20,2011-08-22 17:32:41.986-04,16,3,19
2417,21,2011-08-22 17:32:41.986-04,3,20,23
2418,22,2011-08-22 17:32:41.986-04,17,30,47
2419,23,2011-08-22 17:32:41.986-04,10,8,18
2420,24,2011-08-22 17:32:41.986-04,3,12,15
2421,25,2011-08-22 17:32:41.986-04,6,9,15
2422,26,2011-08-22 17:32:41.986-04,7,8,15
2423,27,2011-08-22 17:32:41.986-04,3,11,14
2424,30,2011-08-22 17:32:41.986-04,7,8,15
2425,31,2011-08-22 17:32:41.986-04,3,8,11
2426,32,2011-08-22 17:32:41.986-04,7,4,11
2427,33,2011-08-22 17:32:41.986-04,3,16,19
2428,34,2011-08-22 17:32:41.986-04,10,5,15
2429,35,2011-08-22 17:32:41.986-04,0,11,11
2430,36,2011-08-22 17:32:41.986-04,1,15,16
2431,37,2011-08-22 17:32:41.986-04,8,7,15
2432,38,2011-08-22 17:32:41.986-04,35,0,35
2433,39,2011-08-22 17:32:41.986-04,9,10,19
2434,40,2011-08-22 17:32:41.986-04,8,5,13
2435,41,2011-08-22 17:32:41.986-04,5,14,19
2436,42,2011-08-22 17:32:41.986-04,0,19,19
2437,43,2011-08-22 17:32:41.986-04,7,8,15
2438,44,2011-08-22 17:32:41.986-04,17,2,19
2439,45,2011-08-22 17:32:41.986-04,9,10,19
2440,46,2011-08-22 17:32:41.986-04,11,8,19
2441,47,2011-08-22 17:32:41.986-04,11,0,11
2442,48,2011-08-22 17:32:41.986-04,0,15,15
2443,49,2011-08-22 17:32:41.986-04,4,11,15
2444,50,2011-08-22 17:32:41.986-04,0,15,15
2445,51,2011-08-22 17:32:41.986-04,7,8,15
2446,52,2011-08-22 17:32:41.986-04,9,5,14
2447,53,2011-08-22 17:32:41.986-04,9,6,15
2448,55,2011-08-22 17:32:41.986-04,0,15,15
2449,56,2011-08-22 17:32:41.986-04,4,11,15
2450,57,2011-08-22 17:32:41.986-04,8,3,11
2451,3,2011-08-22 17:33:42.931-04,10,7,17
2452,5,2011-08-22 17:33:42.931-04,4,11,15
2453,6,2011-08-22 17:33:42.931-04,8,7,15
2454,8,2011-08-22 17:33:42.931-04,3,12,15
2455,9,2011-08-22 17:33:42.931-04,5,14,19
2456,10,2011-08-22 17:33:42.931-04,5,14,19
2457,11,2011-08-22 17:33:42.931-04,4,11,15
2458,12,2011-08-22 17:33:42.931-04,8,7,15
2459,13,2011-08-22 17:33:42.931-04,1,13,14
2460,14,2011-08-22 17:33:42.931-04,0,17,17
2461,15,2011-08-22 17:33:42.931-04,4,11,15
2462,16,2011-08-22 17:33:42.931-04,15,4,19
2463,17,2011-08-22 17:33:42.931-04,4,11,15
2464,18,2011-08-22 17:33:42.931-04,5,10,15
2465,20,2011-08-22 17:33:42.931-04,16,3,19
2466,21,2011-08-22 17:33:42.931-04,3,20,23
2467,22,2011-08-22 17:33:42.931-04,17,30,47
2468,23,2011-08-22 17:33:42.931-04,10,8,18
2469,24,2011-08-22 17:33:42.931-04,3,12,15
2470,25,2011-08-22 17:33:42.931-04,6,9,15
2471,26,2011-08-22 17:33:42.931-04,7,8,15
2472,27,2011-08-22 17:33:42.931-04,3,11,14
2473,30,2011-08-22 17:33:42.931-04,7,8,15
2474,31,2011-08-22 17:33:42.931-04,3,8,11
2475,32,2011-08-22 17:33:42.931-04,9,2,11
2476,33,2011-08-22 17:33:42.931-04,3,16,19
2477,34,2011-08-22 17:33:42.931-04,10,5,15
2478,35,2011-08-22 17:33:42.931-04,0,11,11
2479,36,2011-08-22 17:33:42.931-04,1,15,16
2480,37,2011-08-22 17:33:42.931-04,8,7,15
2481,38,2011-08-22 17:33:42.931-04,35,0,35
2482,39,2011-08-22 17:33:42.931-04,10,9,19
2483,40,2011-08-22 17:33:42.931-04,8,5,13
2484,41,2011-08-22 17:33:42.931-04,5,14,19
2485,42,2011-08-22 17:33:42.931-04,0,19,19
2486,43,2011-08-22 17:33:42.931-04,7,8,15
2487,44,2011-08-22 17:33:42.931-04,17,2,19
2488,45,2011-08-22 17:33:42.931-04,9,10,19
2489,46,2011-08-22 17:33:42.931-04,11,8,19
2490,47,2011-08-22 17:33:42.931-04,11,0,11
2491,48,2011-08-22 17:33:42.931-04,0,15,15
2492,49,2011-08-22 17:33:42.931-04,4,11,15
2493,50,2011-08-22 17:33:42.931-04,0,15,15
2494,51,2011-08-22 17:33:42.931-04,7,8,15
2495,52,2011-08-22 17:33:42.931-04,9,5,14
2496,53,2011-08-22 17:33:42.931-04,9,6,15
2497,55,2011-08-22 17:33:42.931-04,0,15,15
2498,56,2011-08-22 17:33:42.931-04,4,11,15
2499,57,2011-08-22 17:33:42.931-04,8,3,11
2500,3,2011-08-22 17:34:43.859-04,10,7,17
2501,5,2011-08-22 17:34:43.859-04,4,11,15
2502,6,2011-08-22 17:34:43.859-04,8,7,15
2503,8,2011-08-22 17:34:43.859-04,3,12,15
2504,9,2011-08-22 17:34:43.859-04,5,14,19
2505,10,2011-08-22 17:34:43.859-04,5,14,19
2506,11,2011-08-22 17:34:43.859-04,4,11,15
2507,12,2011-08-22 17:34:43.859-04,8,7,15
2508,13,2011-08-22 17:34:43.859-04,1,13,14
2509,14,2011-08-22 17:34:43.859-04,0,17,17
2510,15,2011-08-22 17:34:43.859-04,4,11,15
2511,16,2011-08-22 17:34:43.859-04,15,4,19
2512,17,2011-08-22 17:34:43.859-04,4,11,15
2513,18,2011-08-22 17:34:43.859-04,5,10,15
2514,20,2011-08-22 17:34:43.859-04,16,3,19
2515,21,2011-08-22 17:34:43.859-04,3,20,23
2516,22,2011-08-22 17:34:43.859-04,20,27,47
2517,23,2011-08-22 17:34:43.859-04,10,8,18
2518,24,2011-08-22 17:34:43.859-04,3,12,15
2519,25,2011-08-22 17:34:43.859-04,6,9,15
2520,26,2011-08-22 17:34:43.859-04,7,8,15
2521,27,2011-08-22 17:34:43.859-04,3,11,14
2522,30,2011-08-22 17:34:43.859-04,7,8,15
2523,31,2011-08-22 17:34:43.859-04,3,8,11
2524,32,2011-08-22 17:34:43.859-04,9,2,11
2525,33,2011-08-22 17:34:43.859-04,3,16,19
2526,34,2011-08-22 17:34:43.859-04,10,5,15
2527,35,2011-08-22 17:34:43.859-04,0,11,11
2528,36,2011-08-22 17:34:43.859-04,0,16,16
2529,37,2011-08-22 17:34:43.859-04,8,7,15
2530,38,2011-08-22 17:34:43.859-04,35,0,35
2531,39,2011-08-22 17:34:43.859-04,10,9,19
2532,40,2011-08-22 17:34:43.859-04,8,5,13
2533,41,2011-08-22 17:34:43.859-04,5,14,19
2534,42,2011-08-22 17:34:43.859-04,0,19,19
2535,43,2011-08-22 17:34:43.859-04,7,8,15
2536,44,2011-08-22 17:34:43.859-04,17,2,19
2537,45,2011-08-22 17:34:43.859-04,7,12,19
2538,46,2011-08-22 17:34:43.859-04,11,8,19
2539,47,2011-08-22 17:34:43.859-04,11,0,11
2540,48,2011-08-22 17:34:43.859-04,0,15,15
2541,49,2011-08-22 17:34:43.859-04,4,11,15
2542,50,2011-08-22 17:34:43.859-04,0,15,15
2543,51,2011-08-22 17:34:43.859-04,7,8,15
2544,52,2011-08-22 17:34:43.859-04,9,5,14
2545,53,2011-08-22 17:34:43.859-04,9,6,15
2546,55,2011-08-22 17:34:43.859-04,0,15,15
2547,56,2011-08-22 17:34:43.859-04,4,11,15
2548,57,2011-08-22 17:34:43.859-04,8,3,11
2549,3,2011-08-22 17:35:44.771-04,10,7,17
2550,5,2011-08-22 17:35:44.771-04,4,11,15
2551,6,2011-08-22 17:35:44.771-04,9,6,15
2552,8,2011-08-22 17:35:44.771-04,3,12,15
2553,9,2011-08-22 17:35:44.771-04,5,14,19
2554,10,2011-08-22 17:35:44.771-04,5,14,19
2555,11,2011-08-22 17:35:44.771-04,4,11,15
2556,12,2011-08-22 17:35:44.771-04,8,7,15
2557,13,2011-08-22 17:35:44.771-04,1,13,14
2558,14,2011-08-22 17:35:44.771-04,0,17,17
2559,15,2011-08-22 17:35:44.771-04,4,11,15
2560,16,2011-08-22 17:35:44.771-04,15,4,19
2561,17,2011-08-22 17:35:44.771-04,4,11,15
2562,18,2011-08-22 17:35:44.771-04,5,10,15
2563,20,2011-08-22 17:35:44.771-04,16,3,19
2564,21,2011-08-22 17:35:44.771-04,3,20,23
2565,22,2011-08-22 17:35:44.771-04,20,27,47
2566,23,2011-08-22 17:35:44.771-04,10,8,18
2567,24,2011-08-22 17:35:44.771-04,3,12,15
2568,25,2011-08-22 17:35:44.771-04,6,9,15
2569,26,2011-08-22 17:35:44.771-04,7,8,15
2570,27,2011-08-22 17:35:44.771-04,3,11,14
2571,30,2011-08-22 17:35:44.771-04,7,8,15
2572,31,2011-08-22 17:35:44.771-04,3,8,11
2573,32,2011-08-22 17:35:44.771-04,9,2,11
2574,33,2011-08-22 17:35:44.771-04,3,16,19
2575,34,2011-08-22 17:35:44.771-04,10,5,15
2576,35,2011-08-22 17:35:44.771-04,0,11,11
2577,36,2011-08-22 17:35:44.771-04,0,16,16
2578,37,2011-08-22 17:35:44.771-04,8,7,15
2579,38,2011-08-22 17:35:44.771-04,35,0,35
2580,39,2011-08-22 17:35:44.771-04,10,9,19
2581,40,2011-08-22 17:35:44.771-04,8,5,13
2582,41,2011-08-22 17:35:44.771-04,5,14,19
2583,42,2011-08-22 17:35:44.771-04,0,19,19
2584,43,2011-08-22 17:35:44.771-04,7,8,15
2585,44,2011-08-22 17:35:44.771-04,17,2,19
2586,45,2011-08-22 17:35:44.771-04,6,13,19
2587,46,2011-08-22 17:35:44.771-04,11,8,19
2588,47,2011-08-22 17:35:44.771-04,11,0,11
2589,48,2011-08-22 17:35:44.771-04,0,15,15
2590,49,2011-08-22 17:35:44.771-04,5,10,15
2591,50,2011-08-22 17:35:44.771-04,0,15,15
2592,51,2011-08-22 17:35:44.771-04,7,8,15
2593,52,2011-08-22 17:35:44.771-04,9,5,14
2594,53,2011-08-22 17:35:44.771-04,9,6,15
2595,55,2011-08-22 17:35:44.771-04,2,13,15
2596,56,2011-08-22 17:35:44.771-04,4,11,15
2597,57,2011-08-22 17:35:44.771-04,7,4,11
2598,3,2011-08-22 17:36:45.623-04,10,7,17
2599,5,2011-08-22 17:36:45.623-04,4,11,15
2600,6,2011-08-22 17:36:45.623-04,10,5,15
2601,8,2011-08-22 17:36:45.623-04,3,12,15
2602,9,2011-08-22 17:36:45.623-04,5,14,19
2603,10,2011-08-22 17:36:45.623-04,5,14,19
2604,11,2011-08-22 17:36:45.623-04,4,11,15
2605,12,2011-08-22 17:36:45.623-04,8,7,15
2606,13,2011-08-22 17:36:45.623-04,1,13,14
2607,14,2011-08-22 17:36:45.623-04,0,17,17
2608,15,2011-08-22 17:36:45.623-04,4,11,15
2609,16,2011-08-22 17:36:45.623-04,15,4,19
2610,17,2011-08-22 17:36:45.623-04,4,11,15
2611,18,2011-08-22 17:36:45.623-04,5,10,15
2612,20,2011-08-22 17:36:45.623-04,16,3,19
2613,21,2011-08-22 17:36:45.623-04,3,20,23
2614,22,2011-08-22 17:36:45.623-04,21,26,47
2615,23,2011-08-22 17:36:45.623-04,10,8,18
2616,24,2011-08-22 17:36:45.623-04,2,13,15
2617,25,2011-08-22 17:36:45.623-04,6,9,15
2618,26,2011-08-22 17:36:45.623-04,7,8,15
2619,27,2011-08-22 17:36:45.623-04,3,11,14
2620,30,2011-08-22 17:36:45.623-04,7,8,15
2621,31,2011-08-22 17:36:45.623-04,3,8,11
2622,32,2011-08-22 17:36:45.623-04,9,2,11
2623,33,2011-08-22 17:36:45.623-04,3,16,19
2624,34,2011-08-22 17:36:45.623-04,10,5,15
2625,35,2011-08-22 17:36:45.623-04,0,11,11
2626,36,2011-08-22 17:36:45.623-04,0,15,15
2627,37,2011-08-22 17:36:45.623-04,8,7,15
2628,38,2011-08-22 17:36:45.623-04,35,0,35
2629,39,2011-08-22 17:36:45.623-04,10,9,19
2630,40,2011-08-22 17:36:45.623-04,8,5,13
2631,41,2011-08-22 17:36:45.623-04,5,14,19
2632,42,2011-08-22 17:36:45.623-04,0,19,19
2633,43,2011-08-22 17:36:45.623-04,7,8,15
2634,44,2011-08-22 17:36:45.623-04,17,2,19
2635,45,2011-08-22 17:36:45.623-04,7,12,19
2636,46,2011-08-22 17:36:45.623-04,11,8,19
2637,47,2011-08-22 17:36:45.623-04,11,0,11
2638,48,2011-08-22 17:36:45.623-04,0,15,15
2639,49,2011-08-22 17:36:45.623-04,4,11,15
2640,50,2011-08-22 17:36:45.623-04,0,15,15
2641,51,2011-08-22 17:36:45.623-04,7,8,15
2642,52,2011-08-22 17:36:45.623-04,9,5,14
2643,53,2011-08-22 17:36:45.623-04,9,6,15
2644,55,2011-08-22 17:36:45.623-04,2,13,15
2645,56,2011-08-22 17:36:45.623-04,4,11,15
2646,57,2011-08-22 17:36:45.623-04,7,4,11
2647,3,2011-08-22 17:37:46.631-04,10,7,17
2648,5,2011-08-22 17:37:46.631-04,4,11,15
2649,6,2011-08-22 17:37:46.631-04,10,5,15
2650,8,2011-08-22 17:37:46.631-04,3,12,15
2651,9,2011-08-22 17:37:46.631-04,5,14,19
2652,10,2011-08-22 17:37:46.631-04,5,14,19
2653,11,2011-08-22 17:37:46.631-04,4,11,15
2654,12,2011-08-22 17:37:46.631-04,8,7,15
2655,13,2011-08-22 17:37:46.631-04,1,13,14
2656,14,2011-08-22 17:37:46.631-04,0,17,17
2657,15,2011-08-22 17:37:46.631-04,4,11,15
2658,16,2011-08-22 17:37:46.631-04,16,3,19
2659,17,2011-08-22 17:37:46.631-04,4,11,15
2660,18,2011-08-22 17:37:46.631-04,5,10,15
2661,20,2011-08-22 17:37:46.631-04,16,3,19
2662,21,2011-08-22 17:37:46.631-04,3,20,23
2663,22,2011-08-22 17:37:46.631-04,22,25,47
2664,23,2011-08-22 17:37:46.631-04,10,8,18
2665,24,2011-08-22 17:37:46.631-04,2,13,15
2666,25,2011-08-22 17:37:46.631-04,6,9,15
2667,26,2011-08-22 17:37:46.631-04,7,8,15
2668,27,2011-08-22 17:37:46.631-04,3,11,14
2669,30,2011-08-22 17:37:46.631-04,7,8,15
2670,31,2011-08-22 17:37:46.631-04,3,8,11
2671,32,2011-08-22 17:37:46.631-04,9,2,11
2672,33,2011-08-22 17:37:46.631-04,3,16,19
2673,34,2011-08-22 17:37:46.631-04,10,5,15
2674,35,2011-08-22 17:37:46.631-04,0,11,11
2675,36,2011-08-22 17:37:46.631-04,0,15,15
2676,37,2011-08-22 17:37:46.631-04,8,7,15
2677,38,2011-08-22 17:37:46.631-04,35,0,35
2678,39,2011-08-22 17:37:46.631-04,10,9,19
2679,40,2011-08-22 17:37:46.631-04,8,5,13
2680,41,2011-08-22 17:37:46.631-04,6,13,19
2681,42,2011-08-22 17:37:46.631-04,0,19,19
2682,43,2011-08-22 17:37:46.631-04,7,8,15
2683,44,2011-08-22 17:37:46.631-04,17,2,19
2684,45,2011-08-22 17:37:46.631-04,7,12,19
2685,46,2011-08-22 17:37:46.631-04,11,8,19
2686,47,2011-08-22 17:37:46.631-04,11,0,11
2687,48,2011-08-22 17:37:46.631-04,0,15,15
2688,49,2011-08-22 17:37:46.631-04,4,11,15
2689,50,2011-08-22 17:37:46.631-04,0,15,15
2690,51,2011-08-22 17:37:46.631-04,7,8,15
2691,52,2011-08-22 17:37:46.631-04,9,5,14
2692,53,2011-08-22 17:37:46.631-04,9,6,15
2693,55,2011-08-22 17:37:46.631-04,3,12,15
2694,56,2011-08-22 17:37:46.631-04,4,11,15
2695,57,2011-08-22 17:37:46.631-04,7,4,11
2696,3,2011-08-22 17:38:47.641-04,10,7,17
2697,5,2011-08-22 17:38:47.641-04,4,11,15
2698,6,2011-08-22 17:38:47.641-04,10,5,15
2699,8,2011-08-22 17:38:47.641-04,4,11,15
2700,9,2011-08-22 17:38:47.641-04,5,14,19
2701,10,2011-08-22 17:38:47.641-04,5,14,19
2702,11,2011-08-22 17:38:47.641-04,4,11,15
2703,12,2011-08-22 17:38:47.641-04,8,7,15
2704,13,2011-08-22 17:38:47.641-04,1,13,14
2705,14,2011-08-22 17:38:47.641-04,0,17,17
2706,15,2011-08-22 17:38:47.641-04,4,11,15
2707,16,2011-08-22 17:38:47.641-04,16,3,19
2708,17,2011-08-22 17:38:47.641-04,4,11,15
2709,18,2011-08-22 17:38:47.641-04,5,10,15
2710,20,2011-08-22 17:38:47.641-04,16,3,19
2711,21,2011-08-22 17:38:47.641-04,3,20,23
2712,22,2011-08-22 17:38:47.641-04,22,25,47
2713,23,2011-08-22 17:38:47.641-04,10,8,18
2714,24,2011-08-22 17:38:47.641-04,2,13,15
2715,25,2011-08-22 17:38:47.641-04,6,9,15
2716,26,2011-08-22 17:38:47.641-04,7,8,15
2717,27,2011-08-22 17:38:47.641-04,3,11,14
2718,30,2011-08-22 17:38:47.641-04,7,8,15
2719,31,2011-08-22 17:38:47.641-04,3,8,11
2720,32,2011-08-22 17:38:47.641-04,9,2,11
2721,33,2011-08-22 17:38:47.641-04,1,18,19
2722,34,2011-08-22 17:38:47.641-04,10,5,15
2723,35,2011-08-22 17:38:47.641-04,0,11,11
2724,36,2011-08-22 17:38:47.641-04,0,15,15
2725,37,2011-08-22 17:38:47.641-04,8,7,15
2726,38,2011-08-22 17:38:47.641-04,35,0,35
2727,39,2011-08-22 17:38:47.641-04,10,9,19
2728,40,2011-08-22 17:38:47.641-04,8,5,13
2729,41,2011-08-22 17:38:47.641-04,9,10,19
2730,42,2011-08-22 17:38:47.641-04,0,19,19
2731,43,2011-08-22 17:38:47.641-04,7,8,15
2732,44,2011-08-22 17:38:47.641-04,17,2,19
2733,45,2011-08-22 17:38:47.641-04,7,12,19
2734,46,2011-08-22 17:38:47.641-04,11,8,19
2735,47,2011-08-22 17:38:47.641-04,11,0,11
2736,48,2011-08-22 17:38:47.641-04,0,15,15
2737,49,2011-08-22 17:38:47.641-04,4,11,15
2738,50,2011-08-22 17:38:47.641-04,0,15,15
2739,51,2011-08-22 17:38:47.641-04,7,8,15
2740,52,2011-08-22 17:38:47.641-04,9,5,14
2741,53,2011-08-22 17:38:47.641-04,9,6,15
2742,55,2011-08-22 17:38:47.641-04,3,12,15
2743,56,2011-08-22 17:38:47.641-04,4,11,15
2744,57,2011-08-22 17:38:47.641-04,7,4,11
2745,3,2011-08-22 17:39:48.584-04,10,7,17
2746,5,2011-08-22 17:39:48.584-04,4,11,15
2747,6,2011-08-22 17:39:48.584-04,10,5,15
2748,8,2011-08-22 17:39:48.584-04,4,11,15
2749,9,2011-08-22 17:39:48.584-04,5,14,19
2750,10,2011-08-22 17:39:48.584-04,5,14,19
2751,11,2011-08-22 17:39:48.584-04,4,11,15
2752,12,2011-08-22 17:39:48.584-04,8,7,15
2753,13,2011-08-22 17:39:48.584-04,1,13,14
2754,14,2011-08-22 17:39:48.584-04,0,17,17
2755,15,2011-08-22 17:39:48.584-04,4,11,15
2756,16,2011-08-22 17:39:48.584-04,16,3,19
2757,17,2011-08-22 17:39:48.584-04,4,11,15
2758,18,2011-08-22 17:39:48.584-04,5,10,15
2759,20,2011-08-22 17:39:48.584-04,16,3,19
2760,21,2011-08-22 17:39:48.584-04,4,19,23
2761,22,2011-08-22 17:39:48.584-04,22,25,47
2762,23,2011-08-22 17:39:48.584-04,10,8,18
2763,24,2011-08-22 17:39:48.584-04,2,13,15
2764,25,2011-08-22 17:39:48.584-04,6,9,15
2765,26,2011-08-22 17:39:48.584-04,7,8,15
2766,27,2011-08-22 17:39:48.584-04,3,11,14
2767,30,2011-08-22 17:39:48.584-04,7,8,15
2768,31,2011-08-22 17:39:48.584-04,3,8,11
2769,32,2011-08-22 17:39:48.584-04,9,2,11
2770,33,2011-08-22 17:39:48.584-04,1,18,19
2771,34,2011-08-22 17:39:48.584-04,10,5,15
2772,35,2011-08-22 17:39:48.584-04,0,11,11
2773,36,2011-08-22 17:39:48.584-04,0,15,15
2774,37,2011-08-22 17:39:48.584-04,8,7,15
2775,38,2011-08-22 17:39:48.584-04,34,1,35
2776,39,2011-08-22 17:39:48.584-04,10,9,19
2777,40,2011-08-22 17:39:48.584-04,8,5,13
2778,41,2011-08-22 17:39:48.584-04,9,10,19
2779,42,2011-08-22 17:39:48.584-04,1,18,19
2780,43,2011-08-22 17:39:48.584-04,7,8,15
2781,44,2011-08-22 17:39:48.584-04,17,2,19
2782,45,2011-08-22 17:39:48.584-04,7,12,19
2783,46,2011-08-22 17:39:48.584-04,11,8,19
2784,47,2011-08-22 17:39:48.584-04,11,0,11
2785,48,2011-08-22 17:39:48.584-04,0,15,15
2786,49,2011-08-22 17:39:48.584-04,4,11,15
2787,50,2011-08-22 17:39:48.584-04,0,15,15
2788,51,2011-08-22 17:39:48.584-04,7,8,15
2789,52,2011-08-22 17:39:48.584-04,9,5,14
2790,53,2011-08-22 17:39:48.584-04,9,6,15
2791,55,2011-08-22 17:39:48.584-04,3,12,15
2792,56,2011-08-22 17:39:48.584-04,4,11,15
2793,57,2011-08-22 17:39:48.584-04,7,4,11
2794,3,2011-08-22 17:40:49.589-04,10,7,17
2795,5,2011-08-22 17:40:49.589-04,4,11,15
2796,6,2011-08-22 17:40:49.589-04,10,5,15
2797,8,2011-08-22 17:40:49.589-04,5,10,15
2798,9,2011-08-22 17:40:49.589-04,5,14,19
2799,10,2011-08-22 17:40:49.589-04,6,13,19
2800,11,2011-08-22 17:40:49.589-04,4,11,15
2801,12,2011-08-22 17:40:49.589-04,8,7,15
2802,13,2011-08-22 17:40:49.589-04,1,13,14
2803,14,2011-08-22 17:40:49.589-04,0,17,17
2804,15,2011-08-22 17:40:49.589-04,5,10,15
2805,16,2011-08-22 17:40:49.589-04,16,3,19
2806,17,2011-08-22 17:40:49.589-04,4,11,15
2807,18,2011-08-22 17:40:49.589-04,5,10,15
2808,20,2011-08-22 17:40:49.589-04,16,3,19
2809,21,2011-08-22 17:40:49.589-04,4,19,23
2810,22,2011-08-22 17:40:49.589-04,22,25,47
2811,23,2011-08-22 17:40:49.589-04,10,8,18
2812,24,2011-08-22 17:40:49.589-04,2,13,15
2813,25,2011-08-22 17:40:49.589-04,6,9,15
2814,26,2011-08-22 17:40:49.589-04,7,8,15
2815,27,2011-08-22 17:40:49.589-04,3,11,14
2816,30,2011-08-22 17:40:49.589-04,7,8,15
2817,31,2011-08-22 17:40:49.589-04,3,8,11
2818,32,2011-08-22 17:40:49.589-04,9,2,11
2819,33,2011-08-22 17:40:49.589-04,1,18,19
2820,34,2011-08-22 17:40:49.589-04,10,5,15
2821,35,2011-08-22 17:40:49.589-04,0,11,11
2822,36,2011-08-22 17:40:49.589-04,0,15,15
2823,37,2011-08-22 17:40:49.589-04,8,7,15
2824,38,2011-08-22 17:40:49.589-04,34,1,35
2825,39,2011-08-22 17:40:49.589-04,10,9,19
2826,40,2011-08-22 17:40:49.589-04,8,5,13
2827,41,2011-08-22 17:40:49.589-04,9,10,19
2828,42,2011-08-22 17:40:49.589-04,1,18,19
2829,43,2011-08-22 17:40:49.589-04,7,8,15
2830,44,2011-08-22 17:40:49.589-04,17,2,19
2831,45,2011-08-22 17:40:49.589-04,7,12,19
2832,46,2011-08-22 17:40:49.589-04,11,8,19
2833,47,2011-08-22 17:40:49.589-04,11,0,11
2834,48,2011-08-22 17:40:49.589-04,0,15,15
2835,49,2011-08-22 17:40:49.589-04,4,11,15
2836,50,2011-08-22 17:40:49.589-04,0,15,15
2837,51,2011-08-22 17:40:49.589-04,7,8,15
2838,52,2011-08-22 17:40:49.589-04,9,5,14
2839,53,2011-08-22 17:40:49.589-04,10,5,15
2840,55,2011-08-22 17:40:49.589-04,3,12,15
2841,56,2011-08-22 17:40:49.589-04,4,11,15
2842,57,2011-08-22 17:40:49.589-04,7,4,11
2843,3,2011-08-22 17:41:50.504-04,10,7,17
2844,5,2011-08-22 17:41:50.504-04,3,12,15
2845,6,2011-08-22 17:41:50.504-04,10,5,15
2846,8,2011-08-22 17:41:50.504-04,5,10,15
2847,9,2011-08-22 17:41:50.504-04,5,14,19
2848,10,2011-08-22 17:41:50.504-04,6,13,19
2849,11,2011-08-22 17:41:50.504-04,4,11,15
2850,12,2011-08-22 17:41:50.504-04,8,7,15
2851,13,2011-08-22 17:41:50.504-04,1,13,14
2852,14,2011-08-22 17:41:50.504-04,0,17,17
2853,15,2011-08-22 17:41:50.504-04,6,9,15
2854,16,2011-08-22 17:41:50.504-04,16,3,19
2855,17,2011-08-22 17:41:50.504-04,4,11,15
2856,18,2011-08-22 17:41:50.504-04,5,10,15
2857,20,2011-08-22 17:41:50.504-04,16,3,19
2858,21,2011-08-22 17:41:50.504-04,4,19,23
2859,22,2011-08-22 17:41:50.504-04,22,25,47
2860,23,2011-08-22 17:41:50.504-04,10,8,18
2861,24,2011-08-22 17:41:50.504-04,2,13,15
2862,25,2011-08-22 17:41:50.504-04,6,9,15
2863,26,2011-08-22 17:41:50.504-04,7,8,15
2864,27,2011-08-22 17:41:50.504-04,3,11,14
2865,30,2011-08-22 17:41:50.504-04,6,9,15
2866,31,2011-08-22 17:41:50.504-04,3,8,11
2867,32,2011-08-22 17:41:50.504-04,9,2,11
2868,33,2011-08-22 17:41:50.504-04,1,18,19
2869,34,2011-08-22 17:41:50.504-04,10,5,15
2870,35,2011-08-22 17:41:50.504-04,0,11,11
2871,36,2011-08-22 17:41:50.504-04,0,15,15
2872,37,2011-08-22 17:41:50.504-04,8,7,15
2873,38,2011-08-22 17:41:50.504-04,34,1,35
2874,39,2011-08-22 17:41:50.504-04,10,9,19
2875,40,2011-08-22 17:41:50.504-04,8,5,13
2876,41,2011-08-22 17:41:50.504-04,9,10,19
2877,42,2011-08-22 17:41:50.504-04,1,18,19
2878,43,2011-08-22 17:41:50.504-04,7,8,15
2879,44,2011-08-22 17:41:50.504-04,17,2,19
2880,45,2011-08-22 17:41:50.504-04,7,12,19
2881,46,2011-08-22 17:41:50.504-04,11,8,19
2882,47,2011-08-22 17:41:50.504-04,11,0,11
2883,48,2011-08-22 17:41:50.504-04,0,15,15
2884,49,2011-08-22 17:41:50.504-04,4,11,15
2885,50,2011-08-22 17:41:50.504-04,0,15,15
2886,51,2011-08-22 17:41:50.504-04,7,8,15
2887,52,2011-08-22 17:41:50.504-04,9,5,14
2888,53,2011-08-22 17:41:50.504-04,10,5,15
2889,55,2011-08-22 17:41:50.504-04,3,12,15
2890,56,2011-08-22 17:41:50.504-04,6,9,15
2891,57,2011-08-22 17:41:50.504-04,7,4,11
2892,3,2011-08-22 17:42:51.654-04,10,7,17
2893,5,2011-08-22 17:42:51.654-04,2,13,15
2894,6,2011-08-22 17:42:51.654-04,10,5,15
2895,8,2011-08-22 17:42:51.654-04,5,10,15
2896,9,2011-08-22 17:42:51.654-04,5,14,19
2897,10,2011-08-22 17:42:51.654-04,6,13,19
2898,11,2011-08-22 17:42:51.654-04,4,11,15
2899,12,2011-08-22 17:42:51.654-04,8,7,15
2900,13,2011-08-22 17:42:51.654-04,1,13,14
2901,14,2011-08-22 17:42:51.654-04,0,17,17
2902,15,2011-08-22 17:42:51.654-04,6,9,15
2903,16,2011-08-22 17:42:51.654-04,16,3,19
2904,17,2011-08-22 17:42:51.654-04,4,11,15
2905,18,2011-08-22 17:42:51.654-04,5,10,15
2906,20,2011-08-22 17:42:51.654-04,16,3,19
2907,21,2011-08-22 17:42:51.654-04,4,19,23
2908,22,2011-08-22 17:42:51.654-04,21,26,47
2909,23,2011-08-22 17:42:51.654-04,10,8,18
2910,24,2011-08-22 17:42:51.654-04,1,14,15
2911,25,2011-08-22 17:42:51.654-04,6,9,15
2912,26,2011-08-22 17:42:51.654-04,7,8,15
2913,27,2011-08-22 17:42:51.654-04,3,11,14
2914,30,2011-08-22 17:42:51.654-04,6,9,15
2915,31,2011-08-22 17:42:51.654-04,3,8,11
2916,32,2011-08-22 17:42:51.654-04,9,2,11
2917,33,2011-08-22 17:42:51.654-04,1,18,19
2918,34,2011-08-22 17:42:51.654-04,10,5,15
2919,35,2011-08-22 17:42:51.654-04,0,11,11
2920,36,2011-08-22 17:42:51.654-04,0,15,15
2921,37,2011-08-22 17:42:51.654-04,8,7,15
2922,38,2011-08-22 17:42:51.654-04,34,1,35
2923,39,2011-08-22 17:42:51.654-04,10,9,19
2924,40,2011-08-22 17:42:51.654-04,8,5,13
2925,41,2011-08-22 17:42:51.654-04,10,9,19
2926,42,2011-08-22 17:42:51.654-04,1,18,19
2927,43,2011-08-22 17:42:51.654-04,7,8,15
2928,44,2011-08-22 17:42:51.654-04,17,2,19
2929,45,2011-08-22 17:42:51.654-04,8,11,19
2930,46,2011-08-22 17:42:51.654-04,11,8,19
2931,47,2011-08-22 17:42:51.654-04,11,0,11
2932,48,2011-08-22 17:42:51.654-04,0,15,15
2933,49,2011-08-22 17:42:51.654-04,4,11,15
2934,50,2011-08-22 17:42:51.654-04,0,15,15
2935,51,2011-08-22 17:42:51.654-04,7,8,15
2936,52,2011-08-22 17:42:51.654-04,9,5,14
2937,53,2011-08-22 17:42:51.654-04,9,6,15
2938,55,2011-08-22 17:42:51.654-04,3,12,15
2939,56,2011-08-22 17:42:51.654-04,6,9,15
2940,57,2011-08-22 17:42:51.654-04,7,4,11
2941,3,2011-08-22 17:43:52.868-04,10,7,17
2942,5,2011-08-22 17:43:52.868-04,2,13,15
2943,6,2011-08-22 17:43:52.868-04,10,5,15
2944,8,2011-08-22 17:43:52.868-04,5,10,15
2945,9,2011-08-22 17:43:52.868-04,5,14,19
2946,10,2011-08-22 17:43:52.868-04,6,13,19
2947,11,2011-08-22 17:43:52.868-04,3,12,15
2948,12,2011-08-22 17:43:52.868-04,8,7,15
2949,13,2011-08-22 17:43:52.868-04,1,13,14
2950,14,2011-08-22 17:43:52.868-04,0,17,17
2951,15,2011-08-22 17:43:52.868-04,6,9,15
2952,16,2011-08-22 17:43:52.868-04,16,3,19
2953,17,2011-08-22 17:43:52.868-04,4,11,15
2954,18,2011-08-22 17:43:52.868-04,5,10,15
2955,20,2011-08-22 17:43:52.868-04,17,2,19
2956,21,2011-08-22 17:43:52.868-04,4,19,23
2957,22,2011-08-22 17:43:52.868-04,21,26,47
2958,23,2011-08-22 17:43:52.868-04,10,8,18
2959,24,2011-08-22 17:43:52.868-04,1,14,15
2960,25,2011-08-22 17:43:52.868-04,6,9,15
2961,26,2011-08-22 17:43:52.868-04,7,8,15
2962,27,2011-08-22 17:43:52.868-04,3,11,14
2963,30,2011-08-22 17:43:52.868-04,6,9,15
2964,31,2011-08-22 17:43:52.868-04,3,8,11
2965,32,2011-08-22 17:43:52.868-04,9,2,11
2966,33,2011-08-22 17:43:52.868-04,1,18,19
2967,34,2011-08-22 17:43:52.868-04,10,5,15
2968,35,2011-08-22 17:43:52.868-04,0,11,11
2969,36,2011-08-22 17:43:52.868-04,0,15,15
2970,37,2011-08-22 17:43:52.868-04,8,7,15
2971,38,2011-08-22 17:43:52.868-04,34,1,35
2972,39,2011-08-22 17:43:52.868-04,10,9,19
2973,40,2011-08-22 17:43:52.868-04,8,5,13
2974,41,2011-08-22 17:43:52.868-04,10,9,19
2975,42,2011-08-22 17:43:52.868-04,1,18,19
2976,43,2011-08-22 17:43:52.868-04,8,7,15
2977,44,2011-08-22 17:43:52.868-04,17,2,19
2978,45,2011-08-22 17:43:52.868-04,8,11,19
2979,46,2011-08-22 17:43:52.868-04,11,8,19
2980,47,2011-08-22 17:43:52.868-04,11,0,11
2981,48,2011-08-22 17:43:52.868-04,0,15,15
2982,49,2011-08-22 17:43:52.868-04,4,11,15
2983,50,2011-08-22 17:43:52.868-04,0,15,15
2984,51,2011-08-22 17:43:52.868-04,7,8,15
2985,52,2011-08-22 17:43:52.868-04,10,4,14
2986,53,2011-08-22 17:43:52.868-04,9,6,15
2987,55,2011-08-22 17:43:52.868-04,3,12,15
2988,56,2011-08-22 17:43:52.868-04,6,9,15
2989,57,2011-08-22 17:43:52.868-04,7,4,11
2990,3,2011-08-22 17:44:53.862-04,10,7,17
2991,5,2011-08-22 17:44:53.862-04,2,13,15
2992,6,2011-08-22 17:44:53.862-04,10,5,15
2993,8,2011-08-22 17:44:53.862-04,5,10,15
2994,9,2011-08-22 17:44:53.862-04,5,14,19
2995,10,2011-08-22 17:44:53.862-04,6,13,19
2996,11,2011-08-22 17:44:53.862-04,3,12,15
2997,12,2011-08-22 17:44:53.862-04,8,7,15
2998,13,2011-08-22 17:44:53.862-04,1,13,14
2999,14,2011-08-22 17:44:53.862-04,0,17,17
3000,15,2011-08-22 17:44:53.862-04,6,9,15
3001,16,2011-08-22 17:44:53.862-04,15,4,19
3002,17,2011-08-22 17:44:53.862-04,4,11,15
3003,18,2011-08-22 17:44:53.862-04,5,10,15
3004,20,2011-08-22 17:44:53.862-04,17,2,19
3005,21,2011-08-22 17:44:53.862-04,4,19,23
3006,22,2011-08-22 17:44:53.862-04,21,26,47
3007,23,2011-08-22 17:44:53.862-04,10,8,18
3008,24,2011-08-22 17:44:53.862-04,1,14,15
3009,25,2011-08-22 17:44:53.862-04,6,9,15
3010,26,2011-08-22 17:44:53.862-04,7,8,15
3011,27,2011-08-22 17:44:53.862-04,3,11,14
3012,30,2011-08-22 17:44:53.862-04,6,9,15
3013,31,2011-08-22 17:44:53.862-04,3,8,11
3014,32,2011-08-22 17:44:53.862-04,9,2,11
3015,33,2011-08-22 17:44:53.862-04,1,18,19
3016,34,2011-08-22 17:44:53.862-04,10,5,15
3017,35,2011-08-22 17:44:53.862-04,0,11,11
3018,36,2011-08-22 17:44:53.862-04,0,15,15
3019,37,2011-08-22 17:44:53.862-04,8,7,15
3020,38,2011-08-22 17:44:53.862-04,34,1,35
3021,39,2011-08-22 17:44:53.862-04,10,9,19
3022,40,2011-08-22 17:44:53.862-04,11,2,13
3023,41,2011-08-22 17:44:53.862-04,10,9,19
3024,42,2011-08-22 17:44:53.862-04,2,17,19
3025,43,2011-08-22 17:44:53.862-04,8,7,15
3026,44,2011-08-22 17:44:53.862-04,17,2,19
3027,45,2011-08-22 17:44:53.862-04,8,11,19
3028,46,2011-08-22 17:44:53.862-04,11,8,19
3029,47,2011-08-22 17:44:53.862-04,11,0,11
3030,48,2011-08-22 17:44:53.862-04,0,15,15
3031,49,2011-08-22 17:44:53.862-04,4,11,15
3032,50,2011-08-22 17:44:53.862-04,0,15,15
3033,51,2011-08-22 17:44:53.862-04,6,9,15
3034,52,2011-08-22 17:44:53.862-04,10,4,14
3035,53,2011-08-22 17:44:53.862-04,9,6,15
3036,55,2011-08-22 17:44:53.862-04,3,12,15
3037,56,2011-08-22 17:44:53.862-04,6,9,15
3038,57,2011-08-22 17:44:53.862-04,7,4,11
3039,3,2011-08-22 17:45:54.992-04,10,7,17
3040,5,2011-08-22 17:45:54.992-04,2,13,15
3041,6,2011-08-22 17:45:54.992-04,10,5,15
3042,8,2011-08-22 17:45:54.992-04,5,10,15
3043,9,2011-08-22 17:45:54.992-04,5,14,19
3044,10,2011-08-22 17:45:54.992-04,6,13,19
3045,11,2011-08-22 17:45:54.992-04,2,13,15
3046,12,2011-08-22 17:45:54.992-04,8,7,15
3047,13,2011-08-22 17:45:54.992-04,1,13,14
3048,14,2011-08-22 17:45:54.992-04,0,17,17
3049,15,2011-08-22 17:45:54.992-04,6,9,15
3050,16,2011-08-22 17:45:54.992-04,16,3,19
3051,17,2011-08-22 17:45:54.992-04,4,11,15
3052,18,2011-08-22 17:45:54.992-04,5,10,15
3053,20,2011-08-22 17:45:54.992-04,17,2,19
3054,21,2011-08-22 17:45:54.992-04,4,19,23
3055,22,2011-08-22 17:45:54.992-04,21,26,47
3056,23,2011-08-22 17:45:54.992-04,10,8,18
3057,24,2011-08-22 17:45:54.992-04,0,15,15
3058,25,2011-08-22 17:45:54.992-04,6,9,15
3059,26,2011-08-22 17:45:54.992-04,7,8,15
3060,27,2011-08-22 17:45:54.992-04,3,11,14
3061,30,2011-08-22 17:45:54.992-04,6,9,15
3062,31,2011-08-22 17:45:54.992-04,3,8,11
3063,32,2011-08-22 17:45:54.992-04,9,2,11
3064,33,2011-08-22 17:45:54.992-04,1,18,19
3065,34,2011-08-22 17:45:54.992-04,10,5,15
3066,35,2011-08-22 17:45:54.992-04,0,11,11
3067,36,2011-08-22 17:45:54.992-04,0,15,15
3068,37,2011-08-22 17:45:54.992-04,8,7,15
3069,38,2011-08-22 17:45:54.992-04,34,1,35
3070,39,2011-08-22 17:45:54.992-04,7,12,19
3071,40,2011-08-22 17:45:54.992-04,13,0,13
3072,41,2011-08-22 17:45:54.992-04,10,9,19
3073,42,2011-08-22 17:45:54.992-04,4,15,19
3074,43,2011-08-22 17:45:54.992-04,8,7,15
3075,44,2011-08-22 17:45:54.992-04,17,2,19
3076,45,2011-08-22 17:45:54.992-04,8,11,19
3077,46,2011-08-22 17:45:54.992-04,11,8,19
3078,47,2011-08-22 17:45:54.992-04,11,0,11
3079,48,2011-08-22 17:45:54.992-04,0,15,15
3080,49,2011-08-22 17:45:54.992-04,4,11,15
3081,50,2011-08-22 17:45:54.992-04,0,15,15
3082,51,2011-08-22 17:45:54.992-04,6,9,15
3083,52,2011-08-22 17:45:54.992-04,10,4,14
3084,53,2011-08-22 17:45:54.992-04,9,6,15
3085,55,2011-08-22 17:45:54.992-04,3,12,15
3086,56,2011-08-22 17:45:54.992-04,6,9,15
3087,57,2011-08-22 17:45:54.992-04,7,4,11
3088,3,2011-08-22 17:46:56.103-04,10,7,17
3089,5,2011-08-22 17:46:56.103-04,2,13,15
3090,6,2011-08-22 17:46:56.103-04,10,5,15
3091,8,2011-08-22 17:46:56.103-04,5,10,15
3092,9,2011-08-22 17:46:56.103-04,5,14,19
3093,10,2011-08-22 17:46:56.103-04,6,13,19
3094,11,2011-08-22 17:46:56.103-04,2,13,15
3095,12,2011-08-22 17:46:56.103-04,8,7,15
3096,13,2011-08-22 17:46:56.103-04,1,13,14
3097,14,2011-08-22 17:46:56.103-04,0,17,17
3098,15,2011-08-22 17:46:56.103-04,6,9,15
3099,16,2011-08-22 17:46:56.103-04,16,3,19
3100,17,2011-08-22 17:46:56.103-04,4,11,15
3101,18,2011-08-22 17:46:56.103-04,5,10,15
3102,20,2011-08-22 17:46:56.103-04,17,2,19
3103,21,2011-08-22 17:46:56.103-04,4,19,23
3104,22,2011-08-22 17:46:56.103-04,22,25,47
3105,23,2011-08-22 17:46:56.103-04,10,8,18
3106,24,2011-08-22 17:46:56.103-04,0,15,15
3107,25,2011-08-22 17:46:56.103-04,7,8,15
3108,26,2011-08-22 17:46:56.103-04,7,8,15
3109,27,2011-08-22 17:46:56.103-04,3,11,14
3110,30,2011-08-22 17:46:56.103-04,6,9,15
3111,31,2011-08-22 17:46:56.103-04,3,8,11
3112,32,2011-08-22 17:46:56.103-04,9,2,11
3113,33,2011-08-22 17:46:56.103-04,1,18,19
3114,34,2011-08-22 17:46:56.103-04,10,5,15
3115,35,2011-08-22 17:46:56.103-04,0,11,11
3116,36,2011-08-22 17:46:56.103-04,0,15,15
3117,37,2011-08-22 17:46:56.103-04,8,7,15
3118,38,2011-08-22 17:46:56.103-04,35,0,35
3119,39,2011-08-22 17:46:56.103-04,7,12,19
3120,40,2011-08-22 17:46:56.103-04,13,0,13
3121,41,2011-08-22 17:46:56.103-04,10,9,19
3122,42,2011-08-22 17:46:56.103-04,5,14,19
3123,43,2011-08-22 17:46:56.103-04,8,7,15
3124,44,2011-08-22 17:46:56.103-04,17,2,19
3125,45,2011-08-22 17:46:56.103-04,6,13,19
3126,46,2011-08-22 17:46:56.103-04,11,8,19
3127,47,2011-08-22 17:46:56.103-04,11,0,11
3128,48,2011-08-22 17:46:56.103-04,0,15,15
3129,49,2011-08-22 17:46:56.103-04,4,11,15
3130,50,2011-08-22 17:46:56.103-04,0,15,15
3131,51,2011-08-22 17:46:56.103-04,6,9,15
3132,52,2011-08-22 17:46:56.103-04,10,4,14
3133,53,2011-08-22 17:46:56.103-04,9,6,15
3134,55,2011-08-22 17:46:56.103-04,3,12,15
3135,56,2011-08-22 17:46:56.103-04,6,9,15
3136,57,2011-08-22 17:46:56.103-04,7,4,11
3137,3,2011-08-22 17:47:57.06-04,10,7,17
3138,5,2011-08-22 17:47:57.06-04,2,13,15
3139,6,2011-08-22 17:47:57.06-04,10,5,15
3140,8,2011-08-22 17:47:57.06-04,5,10,15
3141,9,2011-08-22 17:47:57.06-04,5,14,19
3142,10,2011-08-22 17:47:57.06-04,6,13,19
3143,11,2011-08-22 17:47:57.06-04,2,13,15
3144,12,2011-08-22 17:47:57.06-04,8,7,15
3145,13,2011-08-22 17:47:57.06-04,1,13,14
3146,14,2011-08-22 17:47:57.06-04,0,17,17
3147,15,2011-08-22 17:47:57.06-04,6,9,15
3148,16,2011-08-22 17:47:57.06-04,16,3,19
3149,17,2011-08-22 17:47:57.06-04,4,11,15
3150,18,2011-08-22 17:47:57.06-04,5,10,15
3151,20,2011-08-22 17:47:57.06-04,17,2,19
3152,21,2011-08-22 17:47:57.06-04,4,19,23
3153,22,2011-08-22 17:47:57.06-04,21,26,47
3154,23,2011-08-22 17:47:57.06-04,10,8,18
3155,24,2011-08-22 17:47:57.06-04,0,15,15
3156,25,2011-08-22 17:47:57.06-04,7,8,15
3157,26,2011-08-22 17:47:57.06-04,7,8,15
3158,27,2011-08-22 17:47:57.06-04,3,11,14
3159,30,2011-08-22 17:47:57.06-04,6,9,15
3160,31,2011-08-22 17:47:57.06-04,3,8,11
3161,32,2011-08-22 17:47:57.06-04,9,2,11
3162,33,2011-08-22 17:47:57.06-04,1,18,19
3163,34,2011-08-22 17:47:57.06-04,9,6,15
3164,35,2011-08-22 17:47:57.06-04,0,11,11
3165,36,2011-08-22 17:47:57.06-04,0,15,15
3166,37,2011-08-22 17:47:57.06-04,8,7,15
3167,38,2011-08-22 17:47:57.06-04,35,0,35
3168,39,2011-08-22 17:47:57.06-04,6,13,19
3169,40,2011-08-22 17:47:57.06-04,13,0,13
3170,41,2011-08-22 17:47:57.06-04,10,9,19
3171,42,2011-08-22 17:47:57.06-04,5,14,19
3172,43,2011-08-22 17:47:57.06-04,8,7,15
3173,44,2011-08-22 17:47:57.06-04,17,2,19
3174,45,2011-08-22 17:47:57.06-04,6,13,19
3175,46,2011-08-22 17:47:57.06-04,11,8,19
3176,47,2011-08-22 17:47:57.06-04,11,0,11
3177,48,2011-08-22 17:47:57.06-04,0,15,15
3178,49,2011-08-22 17:47:57.06-04,4,11,15
3179,50,2011-08-22 17:47:57.06-04,0,15,15
3180,51,2011-08-22 17:47:57.06-04,6,9,15
3181,52,2011-08-22 17:47:57.06-04,11,3,14
3182,53,2011-08-22 17:47:57.06-04,9,6,15
3183,55,2011-08-22 17:47:57.06-04,3,12,15
3184,56,2011-08-22 17:47:57.06-04,6,9,15
3185,57,2011-08-22 17:47:57.06-04,7,4,11
3186,3,2011-08-22 17:48:58.874-04,10,7,17
3187,5,2011-08-22 17:48:58.874-04,2,13,15
3188,6,2011-08-22 17:48:58.874-04,10,5,15
3189,8,2011-08-22 17:48:58.874-04,5,10,15
3190,9,2011-08-22 17:48:58.874-04,5,14,19
3191,10,2011-08-22 17:48:58.874-04,6,13,19
3192,11,2011-08-22 17:48:58.874-04,2,13,15
3193,12,2011-08-22 17:48:58.874-04,8,7,15
3194,13,2011-08-22 17:48:58.874-04,1,13,14
3195,14,2011-08-22 17:48:58.874-04,0,17,17
3196,15,2011-08-22 17:48:58.874-04,6,9,15
3197,16,2011-08-22 17:48:58.874-04,16,3,19
3198,17,2011-08-22 17:48:58.874-04,4,11,15
3199,18,2011-08-22 17:48:58.874-04,5,10,15
3200,20,2011-08-22 17:48:58.874-04,16,3,19
3201,21,2011-08-22 17:48:58.874-04,4,19,23
3202,22,2011-08-22 17:48:58.874-04,21,26,47
3203,23,2011-08-22 17:48:58.874-04,10,8,18
3204,24,2011-08-22 17:48:58.874-04,0,15,15
3205,25,2011-08-22 17:48:58.874-04,7,8,15
3206,26,2011-08-22 17:48:58.874-04,7,8,15
3207,27,2011-08-22 17:48:58.874-04,3,11,14
3208,30,2011-08-22 17:48:58.874-04,6,9,15
3209,31,2011-08-22 17:48:58.874-04,3,8,11
3210,32,2011-08-22 17:48:58.874-04,9,2,11
3211,33,2011-08-22 17:48:58.874-04,1,18,19
3212,34,2011-08-22 17:48:58.874-04,9,6,15
3213,35,2011-08-22 17:48:58.874-04,0,11,11
3214,36,2011-08-22 17:48:58.874-04,0,15,15
3215,37,2011-08-22 17:48:58.874-04,8,7,15
3216,38,2011-08-22 17:48:58.874-04,35,0,35
3217,39,2011-08-22 17:48:58.874-04,6,13,19
3218,40,2011-08-22 17:48:58.874-04,13,0,13
3219,41,2011-08-22 17:48:58.874-04,10,9,19
3220,42,2011-08-22 17:48:58.874-04,5,14,19
3221,43,2011-08-22 17:48:58.874-04,9,6,15
3222,44,2011-08-22 17:48:58.874-04,16,3,19
3223,45,2011-08-22 17:48:58.874-04,5,14,19
3224,46,2011-08-22 17:48:58.874-04,12,7,19
3225,47,2011-08-22 17:48:58.874-04,11,0,11
3226,48,2011-08-22 17:48:58.874-04,0,15,15
3227,49,2011-08-22 17:48:58.874-04,4,11,15
3228,50,2011-08-22 17:48:58.874-04,0,15,15
3229,51,2011-08-22 17:48:58.874-04,6,9,15
3230,52,2011-08-22 17:48:58.874-04,11,3,14
3231,53,2011-08-22 17:48:58.874-04,9,6,15
3232,55,2011-08-22 17:48:58.874-04,3,12,15
3233,56,2011-08-22 17:48:58.874-04,6,9,15
3234,57,2011-08-22 17:48:58.874-04,7,4,11
3235,3,2011-08-22 17:49:59.823-04,10,7,17
3236,5,2011-08-22 17:49:59.823-04,2,13,15
3237,6,2011-08-22 17:49:59.823-04,10,5,15
3238,8,2011-08-22 17:49:59.823-04,5,10,15
3239,9,2011-08-22 17:49:59.823-04,5,14,19
3240,10,2011-08-22 17:49:59.823-04,6,13,19
3241,11,2011-08-22 17:49:59.823-04,2,13,15
3242,12,2011-08-22 17:49:59.823-04,8,7,15
3243,13,2011-08-22 17:49:59.823-04,1,13,14
3244,14,2011-08-22 17:49:59.823-04,0,17,17
3245,15,2011-08-22 17:49:59.823-04,6,9,15
3246,16,2011-08-22 17:49:59.823-04,16,3,19
3247,17,2011-08-22 17:49:59.823-04,4,11,15
3248,18,2011-08-22 17:49:59.823-04,5,10,15
3249,20,2011-08-22 17:49:59.823-04,15,4,19
3250,21,2011-08-22 17:49:59.823-04,4,19,23
3251,22,2011-08-22 17:49:59.823-04,20,27,47
3252,23,2011-08-22 17:49:59.823-04,10,8,18
3253,24,2011-08-22 17:49:59.823-04,0,15,15
3254,25,2011-08-22 17:49:59.823-04,7,8,15
3255,26,2011-08-22 17:49:59.823-04,7,8,15
3256,27,2011-08-22 17:49:59.823-04,5,9,14
3257,30,2011-08-22 17:49:59.823-04,6,9,15
3258,31,2011-08-22 17:49:59.823-04,3,8,11
3259,32,2011-08-22 17:49:59.823-04,9,2,11
3260,33,2011-08-22 17:49:59.823-04,1,18,19
3261,34,2011-08-22 17:49:59.823-04,9,6,15
3262,35,2011-08-22 17:49:59.823-04,0,11,11
3263,36,2011-08-22 17:49:59.823-04,0,15,15
3264,37,2011-08-22 17:49:59.823-04,8,7,15
3265,38,2011-08-22 17:49:59.823-04,33,2,35
3266,39,2011-08-22 17:49:59.823-04,6,13,19
3267,40,2011-08-22 17:49:59.823-04,13,0,13
3268,41,2011-08-22 17:49:59.823-04,10,9,19
3269,42,2011-08-22 17:49:59.823-04,5,14,19
3270,43,2011-08-22 17:49:59.823-04,10,5,15
3271,44,2011-08-22 17:49:59.823-04,16,3,19
3272,45,2011-08-22 17:49:59.823-04,5,14,19
3273,46,2011-08-22 17:49:59.823-04,12,7,19
3274,47,2011-08-22 17:49:59.823-04,11,0,11
3275,48,2011-08-22 17:49:59.823-04,0,15,15
3276,49,2011-08-22 17:49:59.823-04,4,11,15
3277,50,2011-08-22 17:49:59.823-04,0,15,15
3278,51,2011-08-22 17:49:59.823-04,6,9,15
3279,52,2011-08-22 17:49:59.823-04,12,2,14
3280,53,2011-08-22 17:49:59.823-04,9,6,15
3281,55,2011-08-22 17:49:59.823-04,3,12,15
3282,56,2011-08-22 17:49:59.823-04,6,9,15
3283,57,2011-08-22 17:49:59.823-04,7,4,11
3284,3,2011-08-22 17:51:00.789-04,10,7,17
3285,5,2011-08-22 17:51:00.789-04,2,13,15
3286,6,2011-08-22 17:51:00.789-04,10,5,15
3287,8,2011-08-22 17:51:00.789-04,5,10,15
3288,9,2011-08-22 17:51:00.789-04,7,12,19
3289,10,2011-08-22 17:51:00.789-04,6,13,19
3290,11,2011-08-22 17:51:00.789-04,2,13,15
3291,12,2011-08-22 17:51:00.789-04,8,7,15
3292,13,2011-08-22 17:51:00.789-04,1,13,14
3293,14,2011-08-22 17:51:00.789-04,0,17,17
3294,15,2011-08-22 17:51:00.789-04,6,9,15
3295,16,2011-08-22 17:51:00.789-04,16,3,19
3296,17,2011-08-22 17:51:00.789-04,5,10,15
3297,18,2011-08-22 17:51:00.789-04,5,10,15
3298,20,2011-08-22 17:51:00.789-04,13,6,19
3299,21,2011-08-22 17:51:00.789-04,4,19,23
3300,22,2011-08-22 17:51:00.789-04,21,26,47
3301,23,2011-08-22 17:51:00.789-04,10,8,18
3302,24,2011-08-22 17:51:00.789-04,0,15,15
3303,25,2011-08-22 17:51:00.789-04,7,8,15
3304,26,2011-08-22 17:51:00.789-04,7,8,15
3305,27,2011-08-22 17:51:00.789-04,6,8,14
3306,30,2011-08-22 17:51:00.789-04,6,9,15
3307,31,2011-08-22 17:51:00.789-04,3,8,11
3308,32,2011-08-22 17:51:00.789-04,9,2,11
3309,33,2011-08-22 17:51:00.789-04,1,18,19
3310,34,2011-08-22 17:51:00.789-04,9,6,15
3311,35,2011-08-22 17:51:00.789-04,0,11,11
3312,36,2011-08-22 17:51:00.789-04,1,14,15
3313,37,2011-08-22 17:51:00.789-04,8,7,15
3314,38,2011-08-22 17:51:00.789-04,33,2,35
3315,39,2011-08-22 17:51:00.789-04,7,12,19
3316,40,2011-08-22 17:51:00.789-04,13,0,13
3317,41,2011-08-22 17:51:00.789-04,10,9,19
3318,42,2011-08-22 17:51:00.789-04,7,12,19
3319,43,2011-08-22 17:51:00.789-04,9,6,15
3320,44,2011-08-22 17:51:00.789-04,16,3,19
3321,45,2011-08-22 17:51:00.789-04,5,14,19
3322,46,2011-08-22 17:51:00.789-04,12,7,19
3323,47,2011-08-22 17:51:00.789-04,11,0,11
3324,48,2011-08-22 17:51:00.789-04,0,15,15
3325,49,2011-08-22 17:51:00.789-04,4,11,15
3326,50,2011-08-22 17:51:00.789-04,0,15,15
3327,51,2011-08-22 17:51:00.789-04,6,9,15
3328,52,2011-08-22 17:51:00.789-04,13,1,14
3329,53,2011-08-22 17:51:00.789-04,9,6,15
3330,55,2011-08-22 17:51:00.789-04,3,12,15
3331,56,2011-08-22 17:51:00.789-04,6,9,15
3332,57,2011-08-22 17:51:00.789-04,7,4,11
3333,3,2011-08-22 17:52:01.811-04,10,7,17
3334,5,2011-08-22 17:52:01.811-04,0,15,15
3335,6,2011-08-22 17:52:01.811-04,10,5,15
3336,8,2011-08-22 17:52:01.811-04,5,10,15
3337,9,2011-08-22 17:52:01.811-04,7,12,19
3338,10,2011-08-22 17:52:01.811-04,6,13,19
3339,11,2011-08-22 17:52:01.811-04,2,13,15
3340,12,2011-08-22 17:52:01.811-04,8,7,15
3341,13,2011-08-22 17:52:01.811-04,1,13,14
3342,14,2011-08-22 17:52:01.811-04,0,17,17
3343,15,2011-08-22 17:52:01.811-04,6,9,15
3344,16,2011-08-22 17:52:01.811-04,16,3,19
3345,17,2011-08-22 17:52:01.811-04,5,10,15
3346,18,2011-08-22 17:52:01.811-04,5,10,15
3347,20,2011-08-22 17:52:01.811-04,12,7,19
3348,21,2011-08-22 17:52:01.811-04,4,19,23
3349,22,2011-08-22 17:52:01.811-04,21,26,47
3350,23,2011-08-22 17:52:01.811-04,10,8,18
3351,24,2011-08-22 17:52:01.811-04,0,15,15
3352,25,2011-08-22 17:52:01.811-04,7,8,15
3353,26,2011-08-22 17:52:01.811-04,7,8,15
3354,27,2011-08-22 17:52:01.811-04,6,8,14
3355,30,2011-08-22 17:52:01.811-04,6,9,15
3356,31,2011-08-22 17:52:01.811-04,2,9,11
3357,32,2011-08-22 17:52:01.811-04,9,2,11
3358,33,2011-08-22 17:52:01.811-04,1,18,19
3359,34,2011-08-22 17:52:01.811-04,9,6,15
3360,35,2011-08-22 17:52:01.811-04,0,11,11
3361,36,2011-08-22 17:52:01.811-04,1,14,15
3362,37,2011-08-22 17:52:01.811-04,8,7,15
3363,38,2011-08-22 17:52:01.811-04,33,2,35
3364,39,2011-08-22 17:52:01.811-04,7,12,19
3365,40,2011-08-22 17:52:01.811-04,13,0,13
3366,41,2011-08-22 17:52:01.811-04,10,9,19
3367,42,2011-08-22 17:52:01.811-04,8,11,19
3368,43,2011-08-22 17:52:01.811-04,9,6,15
3369,44,2011-08-22 17:52:01.811-04,16,3,19
3370,45,2011-08-22 17:52:01.811-04,5,14,19
3371,46,2011-08-22 17:52:01.811-04,12,7,19
3372,47,2011-08-22 17:52:01.811-04,11,0,11
3373,48,2011-08-22 17:52:01.811-04,0,15,15
3374,49,2011-08-22 17:52:01.811-04,4,11,15
3375,50,2011-08-22 17:52:01.811-04,0,15,15
3376,51,2011-08-22 17:52:01.811-04,6,9,15
3377,52,2011-08-22 17:52:01.811-04,13,1,14
3378,53,2011-08-22 17:52:01.811-04,9,6,15
3379,55,2011-08-22 17:52:01.811-04,3,12,15
3380,56,2011-08-22 17:52:01.811-04,6,9,15
3381,57,2011-08-22 17:52:01.811-04,7,4,11
3382,3,2011-08-22 17:53:02.775-04,10,7,17
3383,5,2011-08-22 17:53:02.775-04,0,15,15
3384,6,2011-08-22 17:53:02.775-04,10,5,15
3385,8,2011-08-22 17:53:02.775-04,5,10,15
3386,9,2011-08-22 17:53:02.775-04,6,13,19
3387,10,2011-08-22 17:53:02.775-04,6,13,19
3388,11,2011-08-22 17:53:02.775-04,2,13,15
3389,12,2011-08-22 17:53:02.775-04,9,6,15
3390,13,2011-08-22 17:53:02.775-04,1,13,14
3391,14,2011-08-22 17:53:02.775-04,0,17,17
3392,15,2011-08-22 17:53:02.775-04,6,9,15
3393,16,2011-08-22 17:53:02.775-04,16,3,19
3394,17,2011-08-22 17:53:02.775-04,5,10,15
3395,18,2011-08-22 17:53:02.775-04,5,10,15
3396,20,2011-08-22 17:53:02.775-04,9,10,19
3397,21,2011-08-22 17:53:02.775-04,4,19,23
3398,22,2011-08-22 17:53:02.775-04,22,25,47
3399,23,2011-08-22 17:53:02.775-04,10,8,18
3400,24,2011-08-22 17:53:02.775-04,0,15,15
3401,25,2011-08-22 17:53:02.775-04,7,8,15
3402,26,2011-08-22 17:53:02.775-04,7,8,15
3403,27,2011-08-22 17:53:02.775-04,6,8,14
3404,30,2011-08-22 17:53:02.775-04,6,9,15
3405,31,2011-08-22 17:53:02.775-04,2,9,11
3406,32,2011-08-22 17:53:02.775-04,9,2,11
3407,33,2011-08-22 17:53:02.775-04,1,18,19
3408,34,2011-08-22 17:53:02.775-04,9,6,15
3409,35,2011-08-22 17:53:02.775-04,0,11,11
3410,36,2011-08-22 17:53:02.775-04,1,14,15
3411,37,2011-08-22 17:53:02.775-04,8,7,15
3412,38,2011-08-22 17:53:02.775-04,33,2,35
3413,39,2011-08-22 17:53:02.775-04,7,12,19
3414,40,2011-08-22 17:53:02.775-04,13,0,13
3415,41,2011-08-22 17:53:02.775-04,10,9,19
3416,42,2011-08-22 17:53:02.775-04,9,10,19
3417,43,2011-08-22 17:53:02.775-04,9,6,15
3418,44,2011-08-22 17:53:02.775-04,16,3,19
3419,45,2011-08-22 17:53:02.775-04,5,14,19
3420,46,2011-08-22 17:53:02.775-04,11,8,19
3421,47,2011-08-22 17:53:02.775-04,11,0,11
3422,48,2011-08-22 17:53:02.775-04,0,15,15
3423,49,2011-08-22 17:53:02.775-04,4,11,15
3424,50,2011-08-22 17:53:02.775-04,0,15,15
3425,51,2011-08-22 17:53:02.775-04,6,9,15
3426,52,2011-08-22 17:53:02.775-04,13,1,14
3427,53,2011-08-22 17:53:02.775-04,10,5,15
3428,55,2011-08-22 17:53:02.775-04,3,12,15
3429,56,2011-08-22 17:53:02.775-04,6,9,15
3430,57,2011-08-22 17:53:02.775-04,7,4,11
3431,3,2011-08-22 17:54:03.772-04,10,7,17
3432,5,2011-08-22 17:54:03.772-04,0,15,15
3433,6,2011-08-22 17:54:03.772-04,11,4,15
3434,8,2011-08-22 17:54:03.772-04,6,9,15
3435,9,2011-08-22 17:54:03.772-04,6,13,19
3436,10,2011-08-22 17:54:03.772-04,6,13,19
3437,11,2011-08-22 17:54:03.772-04,2,13,15
3438,12,2011-08-22 17:54:03.772-04,9,6,15
3439,13,2011-08-22 17:54:03.772-04,1,13,14
3440,14,2011-08-22 17:54:03.772-04,0,17,17
3441,15,2011-08-22 17:54:03.772-04,6,9,15
3442,16,2011-08-22 17:54:03.772-04,16,3,19
3443,17,2011-08-22 17:54:03.772-04,5,10,15
3444,18,2011-08-22 17:54:03.772-04,5,10,15
3445,20,2011-08-22 17:54:03.772-04,9,10,19
3446,21,2011-08-22 17:54:03.772-04,4,19,23
3447,22,2011-08-22 17:54:03.772-04,22,25,47
3448,23,2011-08-22 17:54:03.772-04,10,8,18
3449,24,2011-08-22 17:54:03.772-04,0,15,15
3450,25,2011-08-22 17:54:03.772-04,7,8,15
3451,26,2011-08-22 17:54:03.772-04,7,8,15
3452,27,2011-08-22 17:54:03.772-04,6,8,14
3453,30,2011-08-22 17:54:03.772-04,6,9,15
3454,31,2011-08-22 17:54:03.772-04,2,9,11
3455,32,2011-08-22 17:54:03.772-04,9,2,11
3456,33,2011-08-22 17:54:03.772-04,1,18,19
3457,34,2011-08-22 17:54:03.772-04,9,6,15
3458,35,2011-08-22 17:54:03.772-04,0,11,11
3459,36,2011-08-22 17:54:03.772-04,1,14,15
3460,37,2011-08-22 17:54:03.772-04,8,7,15
3461,38,2011-08-22 17:54:03.772-04,33,2,35
3462,39,2011-08-22 17:54:03.772-04,7,12,19
3463,40,2011-08-22 17:54:03.772-04,13,0,13
3464,41,2011-08-22 17:54:03.772-04,10,9,19
3465,42,2011-08-22 17:54:03.772-04,9,10,19
3466,43,2011-08-22 17:54:03.772-04,9,6,15
3467,44,2011-08-22 17:54:03.772-04,16,3,19
3468,45,2011-08-22 17:54:03.772-04,5,14,19
3469,46,2011-08-22 17:54:03.772-04,11,8,19
3470,47,2011-08-22 17:54:03.772-04,11,0,11
3471,48,2011-08-22 17:54:03.772-04,0,15,15
3472,49,2011-08-22 17:54:03.772-04,4,11,15
3473,50,2011-08-22 17:54:03.772-04,0,15,15
3474,51,2011-08-22 17:54:03.772-04,6,9,15
3475,52,2011-08-22 17:54:03.772-04,12,2,14
3476,53,2011-08-22 17:54:03.772-04,9,6,15
3477,55,2011-08-22 17:54:03.772-04,3,12,15
3478,56,2011-08-22 17:54:03.772-04,5,10,15
3479,57,2011-08-22 17:54:03.772-04,7,4,11
3480,3,2011-08-22 17:55:04.723-04,9,8,17
3481,5,2011-08-22 17:55:04.723-04,0,15,15
3482,6,2011-08-22 17:55:04.723-04,11,4,15
3483,8,2011-08-22 17:55:04.723-04,6,9,15
3484,9,2011-08-22 17:55:04.723-04,6,13,19
3485,10,2011-08-22 17:55:04.723-04,6,13,19
3486,11,2011-08-22 17:55:04.723-04,2,13,15
3487,12,2011-08-22 17:55:04.723-04,9,6,15
3488,13,2011-08-22 17:55:04.723-04,1,13,14
3489,14,2011-08-22 17:55:04.723-04,0,17,17
3490,15,2011-08-22 17:55:04.723-04,6,9,15
3491,16,2011-08-22 17:55:04.723-04,16,3,19
3492,17,2011-08-22 17:55:04.723-04,5,10,15
3493,18,2011-08-22 17:55:04.723-04,5,10,15
3494,20,2011-08-22 17:55:04.723-04,9,10,19
3495,21,2011-08-22 17:55:04.723-04,4,19,23
3496,22,2011-08-22 17:55:04.723-04,22,25,47
3497,23,2011-08-22 17:55:04.723-04,10,8,18
3498,24,2011-08-22 17:55:04.723-04,0,15,15
3499,25,2011-08-22 17:55:04.723-04,7,8,15
3500,26,2011-08-22 17:55:04.723-04,7,8,15
3501,27,2011-08-22 17:55:04.723-04,6,8,14
3502,30,2011-08-22 17:55:04.723-04,6,9,15
3503,31,2011-08-22 17:55:04.723-04,2,9,11
3504,32,2011-08-22 17:55:04.723-04,9,2,11
3505,33,2011-08-22 17:55:04.723-04,1,18,19
3506,34,2011-08-22 17:55:04.723-04,9,6,15
3507,35,2011-08-22 17:55:04.723-04,0,11,11
3508,36,2011-08-22 17:55:04.723-04,1,14,15
3509,37,2011-08-22 17:55:04.723-04,8,7,15
3510,38,2011-08-22 17:55:04.723-04,33,2,35
3511,39,2011-08-22 17:55:04.723-04,7,12,19
3512,40,2011-08-22 17:55:04.723-04,12,1,13
3513,41,2011-08-22 17:55:04.723-04,10,9,19
3514,42,2011-08-22 17:55:04.723-04,9,10,19
3515,43,2011-08-22 17:55:04.723-04,9,6,15
3516,44,2011-08-22 17:55:04.723-04,16,3,19
3517,45,2011-08-22 17:55:04.723-04,5,14,19
3518,46,2011-08-22 17:55:04.723-04,11,8,19
3519,47,2011-08-22 17:55:04.723-04,11,0,11
3520,48,2011-08-22 17:55:04.723-04,0,15,15
3521,49,2011-08-22 17:55:04.723-04,4,11,15
3522,50,2011-08-22 17:55:04.723-04,0,15,15
3523,51,2011-08-22 17:55:04.723-04,6,9,15
3524,52,2011-08-22 17:55:04.723-04,12,2,14
3525,53,2011-08-22 17:55:04.723-04,9,6,15
3526,55,2011-08-22 17:55:04.723-04,3,12,15
3527,56,2011-08-22 17:55:04.723-04,5,10,15
3528,57,2011-08-22 17:55:04.723-04,7,4,11
3529,3,2011-08-22 17:56:05.57-04,9,8,17
3530,5,2011-08-22 17:56:05.57-04,0,15,15
3531,6,2011-08-22 17:56:05.57-04,11,4,15
3532,8,2011-08-22 17:56:05.57-04,6,9,15
3533,9,2011-08-22 17:56:05.57-04,4,15,19
3534,10,2011-08-22 17:56:05.57-04,6,13,19
3535,11,2011-08-22 17:56:05.57-04,2,13,15
3536,12,2011-08-22 17:56:05.57-04,9,6,15
3537,13,2011-08-22 17:56:05.57-04,1,13,14
3538,14,2011-08-22 17:56:05.57-04,0,17,17
3539,15,2011-08-22 17:56:05.57-04,6,9,15
3540,16,2011-08-22 17:56:05.57-04,16,3,19
3541,17,2011-08-22 17:56:05.57-04,5,10,15
3542,18,2011-08-22 17:56:05.57-04,5,10,15
3543,20,2011-08-22 17:56:05.57-04,9,10,19
3544,21,2011-08-22 17:56:05.57-04,3,20,23
3545,22,2011-08-22 17:56:05.57-04,23,24,47
3546,23,2011-08-22 17:56:05.57-04,10,8,18
3547,24,2011-08-22 17:56:05.57-04,2,13,15
3548,25,2011-08-22 17:56:05.57-04,7,8,15
3549,26,2011-08-22 17:56:05.57-04,7,8,15
3550,27,2011-08-22 17:56:05.57-04,6,8,14
3551,30,2011-08-22 17:56:05.57-04,6,9,15
3552,31,2011-08-22 17:56:05.57-04,2,9,11
3553,32,2011-08-22 17:56:05.57-04,9,2,11
3554,33,2011-08-22 17:56:05.57-04,1,18,19
3555,34,2011-08-22 17:56:05.57-04,9,6,15
3556,35,2011-08-22 17:56:05.57-04,0,11,11
3557,36,2011-08-22 17:56:05.57-04,1,14,15
3558,37,2011-08-22 17:56:05.57-04,8,7,15
3559,38,2011-08-22 17:56:05.57-04,34,1,35
3560,39,2011-08-22 17:56:05.57-04,7,12,19
3561,40,2011-08-22 17:56:05.57-04,12,1,13
3562,41,2011-08-22 17:56:05.57-04,10,9,19
3563,42,2011-08-22 17:56:05.57-04,10,9,19
3564,43,2011-08-22 17:56:05.57-04,9,6,15
3565,44,2011-08-22 17:56:05.57-04,16,3,19
3566,45,2011-08-22 17:56:05.57-04,5,14,19
3567,46,2011-08-22 17:56:05.57-04,11,8,19
3568,47,2011-08-22 17:56:05.57-04,11,0,11
3569,48,2011-08-22 17:56:05.57-04,0,15,15
3570,49,2011-08-22 17:56:05.57-04,4,11,15
3571,50,2011-08-22 17:56:05.57-04,0,15,15
3572,51,2011-08-22 17:56:05.57-04,6,9,15
3573,52,2011-08-22 17:56:05.57-04,12,2,14
3574,53,2011-08-22 17:56:05.57-04,9,6,15
3575,55,2011-08-22 17:56:05.57-04,3,12,15
3576,56,2011-08-22 17:56:05.57-04,5,10,15
3577,57,2011-08-22 17:56:05.57-04,7,4,11
3578,3,2011-08-22 17:57:06.545-04,9,8,17
3579,5,2011-08-22 17:57:06.545-04,0,15,15
3580,6,2011-08-22 17:57:06.545-04,11,4,15
3581,8,2011-08-22 17:57:06.545-04,6,9,15
3582,9,2011-08-22 17:57:06.545-04,4,15,19
3583,10,2011-08-22 17:57:06.545-04,7,12,19
3584,11,2011-08-22 17:57:06.545-04,2,13,15
3585,12,2011-08-22 17:57:06.545-04,9,6,15
3586,13,2011-08-22 17:57:06.545-04,1,13,14
3587,14,2011-08-22 17:57:06.545-04,0,17,17
3588,15,2011-08-22 17:57:06.545-04,6,9,15
3589,16,2011-08-22 17:57:06.545-04,16,3,19
3590,17,2011-08-22 17:57:06.545-04,5,10,15
3591,18,2011-08-22 17:57:06.545-04,5,10,15
3592,20,2011-08-22 17:57:06.545-04,7,12,19
3593,21,2011-08-22 17:57:06.545-04,3,20,23
3594,22,2011-08-22 17:57:06.545-04,23,24,47
3595,23,2011-08-22 17:57:06.545-04,10,8,18
3596,24,2011-08-22 17:57:06.545-04,2,13,15
3597,25,2011-08-22 17:57:06.545-04,8,7,15
3598,26,2011-08-22 17:57:06.545-04,7,8,15
3599,27,2011-08-22 17:57:06.545-04,6,8,14
3600,30,2011-08-22 17:57:06.545-04,6,9,15
3601,31,2011-08-22 17:57:06.545-04,2,9,11
3602,32,2011-08-22 17:57:06.545-04,9,2,11
3603,33,2011-08-22 17:57:06.545-04,1,18,19
3604,34,2011-08-22 17:57:06.545-04,9,6,15
3605,35,2011-08-22 17:57:06.545-04,0,11,11
3606,36,2011-08-22 17:57:06.545-04,1,14,15
3607,37,2011-08-22 17:57:06.545-04,8,7,15
3608,38,2011-08-22 17:57:06.545-04,34,1,35
3609,39,2011-08-22 17:57:06.545-04,7,12,19
3610,40,2011-08-22 17:57:06.545-04,11,2,13
3611,41,2011-08-22 17:57:06.545-04,10,9,19
3612,42,2011-08-22 17:57:06.545-04,9,10,19
3613,43,2011-08-22 17:57:06.545-04,8,7,15
3614,44,2011-08-22 17:57:06.545-04,16,3,19
3615,45,2011-08-22 17:57:06.545-04,5,14,19
3616,46,2011-08-22 17:57:06.545-04,11,8,19
3617,47,2011-08-22 17:57:06.545-04,11,0,11
3618,48,2011-08-22 17:57:06.545-04,0,15,15
3619,49,2011-08-22 17:57:06.545-04,4,11,15
3620,50,2011-08-22 17:57:06.545-04,0,15,15
3621,51,2011-08-22 17:57:06.545-04,6,9,15
3622,52,2011-08-22 17:57:06.545-04,12,2,14
3623,53,2011-08-22 17:57:06.545-04,9,6,15
3624,55,2011-08-22 17:57:06.545-04,3,12,15
3625,56,2011-08-22 17:57:06.545-04,5,10,15
3626,57,2011-08-22 17:57:06.545-04,7,4,11
3627,3,2011-08-22 17:58:07.576-04,9,8,17
3628,5,2011-08-22 17:58:07.576-04,0,15,15
3629,6,2011-08-22 17:58:07.576-04,11,4,15
3630,8,2011-08-22 17:58:07.576-04,6,9,15
3631,9,2011-08-22 17:58:07.576-04,4,15,19
3632,10,2011-08-22 17:58:07.576-04,7,12,19
3633,11,2011-08-22 17:58:07.576-04,1,14,15
3634,12,2011-08-22 17:58:07.576-04,9,6,15
3635,13,2011-08-22 17:58:07.576-04,1,13,14
3636,14,2011-08-22 17:58:07.576-04,0,17,17
3637,15,2011-08-22 17:58:07.576-04,6,9,15
3638,16,2011-08-22 17:58:07.576-04,16,3,19
3639,17,2011-08-22 17:58:07.576-04,5,10,15
3640,18,2011-08-22 17:58:07.576-04,5,10,15
3641,20,2011-08-22 17:58:07.576-04,7,12,19
3642,21,2011-08-22 17:58:07.576-04,1,22,23
3643,22,2011-08-22 17:58:07.576-04,23,24,47
3644,23,2011-08-22 17:58:07.576-04,10,8,18
3645,24,2011-08-22 17:58:07.576-04,2,13,15
3646,25,2011-08-22 17:58:07.576-04,8,7,15
3647,26,2011-08-22 17:58:07.576-04,7,8,15
3648,27,2011-08-22 17:58:07.576-04,6,8,14
3649,30,2011-08-22 17:58:07.576-04,6,9,15
3650,31,2011-08-22 17:58:07.576-04,2,9,11
3651,32,2011-08-22 17:58:07.576-04,9,2,11
3652,33,2011-08-22 17:58:07.576-04,1,18,19
3653,34,2011-08-22 17:58:07.576-04,9,6,15
3654,35,2011-08-22 17:58:07.576-04,0,11,11
3655,36,2011-08-22 17:58:07.576-04,1,14,15
3656,37,2011-08-22 17:58:07.576-04,8,7,15
3657,38,2011-08-22 17:58:07.576-04,34,1,35
3658,39,2011-08-22 17:58:07.576-04,7,12,19
3659,40,2011-08-22 17:58:07.576-04,11,2,13
3660,41,2011-08-22 17:58:07.576-04,10,9,19
3661,42,2011-08-22 17:58:07.576-04,8,11,19
3662,43,2011-08-22 17:58:07.576-04,8,7,15
3663,44,2011-08-22 17:58:07.576-04,16,3,19
3664,45,2011-08-22 17:58:07.576-04,5,14,19
3665,46,2011-08-22 17:58:07.576-04,11,8,19
3666,47,2011-08-22 17:58:07.576-04,11,0,11
3667,48,2011-08-22 17:58:07.576-04,0,15,15
3668,49,2011-08-22 17:58:07.576-04,4,11,15
3669,50,2011-08-22 17:58:07.576-04,0,15,15
3670,51,2011-08-22 17:58:07.576-04,6,9,15
3671,52,2011-08-22 17:58:07.576-04,12,2,14
3672,53,2011-08-22 17:58:07.576-04,9,6,15
3673,55,2011-08-22 17:58:07.576-04,3,12,15
3674,56,2011-08-22 17:58:07.576-04,5,10,15
3675,57,2011-08-22 17:58:07.576-04,7,4,11
3676,3,2011-08-22 17:58:07.576-04,9,8,17
3677,5,2011-08-22 17:58:07.576-04,0,15,15
3678,6,2011-08-22 17:58:07.576-04,11,4,15
3679,8,2011-08-22 17:58:07.576-04,6,9,15
3680,9,2011-08-22 17:58:07.576-04,4,15,19
3681,10,2011-08-22 17:58:07.576-04,7,12,19
3682,11,2011-08-22 17:58:07.576-04,1,14,15
3683,12,2011-08-22 17:58:07.576-04,9,6,15
3684,13,2011-08-22 17:58:07.576-04,1,13,14
3685,14,2011-08-22 17:58:07.576-04,0,17,17
3686,15,2011-08-22 17:58:07.576-04,6,9,15
3687,16,2011-08-22 17:58:07.576-04,16,3,19
3688,17,2011-08-22 17:58:07.576-04,5,10,15
3689,18,2011-08-22 17:58:07.576-04,5,10,15
3690,20,2011-08-22 17:58:07.576-04,7,12,19
3691,21,2011-08-22 17:58:07.576-04,1,22,23
3692,22,2011-08-22 17:58:07.576-04,23,24,47
3693,23,2011-08-22 17:58:07.576-04,10,8,18
3694,24,2011-08-22 17:58:07.576-04,2,13,15
3695,25,2011-08-22 17:58:07.576-04,8,7,15
3696,26,2011-08-22 17:58:07.576-04,7,8,15
3697,27,2011-08-22 17:58:07.576-04,6,8,14
3698,30,2011-08-22 17:58:07.576-04,6,9,15
3699,31,2011-08-22 17:58:07.576-04,2,9,11
3700,32,2011-08-22 17:58:07.576-04,9,2,11
3701,33,2011-08-22 17:58:07.576-04,1,18,19
3702,34,2011-08-22 17:58:07.576-04,9,6,15
3703,35,2011-08-22 17:58:07.576-04,0,11,11
3704,36,2011-08-22 17:58:07.576-04,1,14,15
3705,37,2011-08-22 17:58:07.576-04,8,7,15
3706,38,2011-08-22 17:58:07.576-04,34,1,35
3707,39,2011-08-22 17:58:07.576-04,7,12,19
3708,40,2011-08-22 17:58:07.576-04,11,2,13
3709,41,2011-08-22 17:58:07.576-04,10,9,19
3710,42,2011-08-22 17:58:07.576-04,8,11,19
3711,43,2011-08-22 17:58:07.576-04,8,7,15
3712,44,2011-08-22 17:58:07.576-04,16,3,19
3713,45,2011-08-22 17:58:07.576-04,5,14,19
3714,46,2011-08-22 17:58:07.576-04,11,8,19
3715,47,2011-08-22 17:58:07.576-04,11,0,11
3716,48,2011-08-22 17:58:07.576-04,0,15,15
3717,49,2011-08-22 17:58:07.576-04,4,11,15
3718,50,2011-08-22 17:58:07.576-04,0,15,15
3719,51,2011-08-22 17:58:07.576-04,6,9,15
3720,52,2011-08-22 17:58:07.576-04,12,2,14
3721,53,2011-08-22 17:58:07.576-04,9,6,15
3722,55,2011-08-22 17:58:07.576-04,3,12,15
3723,56,2011-08-22 17:58:07.576-04,5,10,15
3724,57,2011-08-22 17:58:07.576-04,7,4,11
3725,3,2011-08-22 17:59:08.447-04,9,8,17
3726,5,2011-08-22 17:59:08.447-04,0,15,15
3727,6,2011-08-22 17:59:08.447-04,11,4,15
3728,8,2011-08-22 17:59:08.447-04,6,9,15
3729,9,2011-08-22 17:59:08.447-04,4,15,19
3730,10,2011-08-22 17:59:08.447-04,7,12,19
3731,11,2011-08-22 17:59:08.447-04,1,14,15
3732,12,2011-08-22 17:59:08.447-04,9,6,15
3733,13,2011-08-22 17:59:08.447-04,1,13,14
3734,14,2011-08-22 17:59:08.447-04,0,17,17
3735,15,2011-08-22 17:59:08.447-04,6,9,15
3736,16,2011-08-22 17:59:08.447-04,16,3,19
3737,17,2011-08-22 17:59:08.447-04,5,10,15
3738,18,2011-08-22 17:59:08.447-04,5,10,15
3739,20,2011-08-22 17:59:08.447-04,7,12,19
3740,21,2011-08-22 17:59:08.447-04,2,21,23
3741,22,2011-08-22 17:59:08.447-04,23,24,47
3742,23,2011-08-22 17:59:08.447-04,10,8,18
3743,24,2011-08-22 17:59:08.447-04,2,13,15
3744,25,2011-08-22 17:59:08.447-04,8,7,15
3745,26,2011-08-22 17:59:08.447-04,7,8,15
3746,27,2011-08-22 17:59:08.447-04,6,8,14
3747,30,2011-08-22 17:59:08.447-04,6,9,15
3748,31,2011-08-22 17:59:08.447-04,3,8,11
3749,32,2011-08-22 17:59:08.447-04,9,2,11
3750,33,2011-08-22 17:59:08.447-04,1,18,19
3751,34,2011-08-22 17:59:08.447-04,9,6,15
3752,35,2011-08-22 17:59:08.447-04,0,11,11
3753,36,2011-08-22 17:59:08.447-04,1,14,15
3754,37,2011-08-22 17:59:08.447-04,8,7,15
3755,38,2011-08-22 17:59:08.447-04,34,1,35
3756,39,2011-08-22 17:59:08.447-04,7,12,19
3757,40,2011-08-22 17:59:08.447-04,11,2,13
3758,41,2011-08-22 17:59:08.447-04,10,9,19
3759,42,2011-08-22 17:59:08.447-04,8,11,19
3760,43,2011-08-22 17:59:08.447-04,8,7,15
3761,44,2011-08-22 17:59:08.447-04,16,3,19
3762,45,2011-08-22 17:59:08.447-04,5,14,19
3763,46,2011-08-22 17:59:08.447-04,11,8,19
3764,47,2011-08-22 17:59:08.447-04,10,1,11
3765,48,2011-08-22 17:59:08.447-04,0,15,15
3766,49,2011-08-22 17:59:08.447-04,4,11,15
3767,50,2011-08-22 17:59:08.447-04,0,15,15
3768,51,2011-08-22 17:59:08.447-04,6,9,15
3769,52,2011-08-22 17:59:08.447-04,12,2,14
3770,53,2011-08-22 17:59:08.447-04,9,6,15
3771,55,2011-08-22 17:59:08.447-04,3,12,15
3772,56,2011-08-22 17:59:08.447-04,5,10,15
3773,57,2011-08-22 17:59:08.447-04,7,4,11
3774,3,2011-08-22 18:00:09.428-04,9,8,17
3775,5,2011-08-22 18:00:09.428-04,0,15,15
3776,6,2011-08-22 18:00:09.428-04,11,4,15
3777,8,2011-08-22 18:00:09.428-04,6,9,15
3778,9,2011-08-22 18:00:09.428-04,4,15,19
3779,10,2011-08-22 18:00:09.428-04,7,12,19
3780,11,2011-08-22 18:00:09.428-04,1,14,15
3781,12,2011-08-22 18:00:09.428-04,9,6,15
3782,13,2011-08-22 18:00:09.428-04,1,13,14
3783,14,2011-08-22 18:00:09.428-04,0,17,17
3784,15,2011-08-22 18:00:09.428-04,6,9,15
3785,16,2011-08-22 18:00:09.428-04,16,3,19
3786,17,2011-08-22 18:00:09.428-04,5,10,15
3787,18,2011-08-22 18:00:09.428-04,5,10,15
3788,20,2011-08-22 18:00:09.428-04,7,12,19
3789,21,2011-08-22 18:00:09.428-04,2,21,23
3790,22,2011-08-22 18:00:09.428-04,23,24,47
3791,23,2011-08-22 18:00:09.428-04,10,8,18
3792,24,2011-08-22 18:00:09.428-04,3,12,15
3793,25,2011-08-22 18:00:09.428-04,8,7,15
3794,26,2011-08-22 18:00:09.428-04,7,8,15
3795,27,2011-08-22 18:00:09.428-04,6,8,14
3796,30,2011-08-22 18:00:09.428-04,7,8,15
3797,31,2011-08-22 18:00:09.428-04,3,8,11
3798,32,2011-08-22 18:00:09.428-04,9,2,11
3799,33,2011-08-22 18:00:09.428-04,1,18,19
3800,34,2011-08-22 18:00:09.428-04,9,6,15
3801,35,2011-08-22 18:00:09.428-04,0,11,11
3802,36,2011-08-22 18:00:09.428-04,1,14,15
3803,37,2011-08-22 18:00:09.428-04,8,7,15
3804,38,2011-08-22 18:00:09.428-04,34,1,35
3805,39,2011-08-22 18:00:09.428-04,7,12,19
3806,40,2011-08-22 18:00:09.428-04,11,2,13
3807,41,2011-08-22 18:00:09.428-04,10,9,19
3808,42,2011-08-22 18:00:09.428-04,8,11,19
3809,43,2011-08-22 18:00:09.428-04,8,7,15
3810,44,2011-08-22 18:00:09.428-04,16,3,19
3811,45,2011-08-22 18:00:09.428-04,5,14,19
3812,46,2011-08-22 18:00:09.428-04,11,8,19
3813,47,2011-08-22 18:00:09.428-04,10,1,11
3814,48,2011-08-22 18:00:09.428-04,0,15,15
3815,49,2011-08-22 18:00:09.428-04,4,11,15
3816,50,2011-08-22 18:00:09.428-04,0,15,15
3817,51,2011-08-22 18:00:09.428-04,6,9,15
3818,52,2011-08-22 18:00:09.428-04,12,2,14
3819,53,2011-08-22 18:00:09.428-04,9,6,15
3820,55,2011-08-22 18:00:09.428-04,6,9,15
3821,56,2011-08-22 18:00:09.428-04,5,10,15
3822,57,2011-08-22 18:00:09.428-04,7,4,11
3823,3,2011-08-22 18:01:10.291-04,9,8,17
3824,5,2011-08-22 18:01:10.291-04,0,15,15
3825,6,2011-08-22 18:01:10.291-04,12,3,15
3826,8,2011-08-22 18:01:10.291-04,6,9,15
3827,9,2011-08-22 18:01:10.291-04,5,14,19
3828,10,2011-08-22 18:01:10.291-04,7,12,19
3829,11,2011-08-22 18:01:10.291-04,1,14,15
3830,12,2011-08-22 18:01:10.291-04,9,6,15
3831,13,2011-08-22 18:01:10.291-04,1,13,14
3832,14,2011-08-22 18:01:10.291-04,0,17,17
3833,15,2011-08-22 18:01:10.291-04,6,9,15
3834,16,2011-08-22 18:01:10.291-04,16,3,19
3835,17,2011-08-22 18:01:10.291-04,5,10,15
3836,18,2011-08-22 18:01:10.291-04,5,10,15
3837,20,2011-08-22 18:01:10.291-04,7,12,19
3838,21,2011-08-22 18:01:10.291-04,2,21,23
3839,22,2011-08-22 18:01:10.291-04,23,24,47
3840,23,2011-08-22 18:01:10.291-04,10,8,18
3841,24,2011-08-22 18:01:10.291-04,3,12,15
3842,25,2011-08-22 18:01:10.291-04,9,6,15
3843,26,2011-08-22 18:01:10.291-04,7,8,15
3844,27,2011-08-22 18:01:10.291-04,6,8,14
3845,30,2011-08-22 18:01:10.291-04,7,8,15
3846,31,2011-08-22 18:01:10.291-04,3,8,11
3847,32,2011-08-22 18:01:10.291-04,9,2,11
3848,33,2011-08-22 18:01:10.291-04,1,18,19
3849,34,2011-08-22 18:01:10.291-04,9,6,15
3850,35,2011-08-22 18:01:10.291-04,0,11,11
3851,36,2011-08-22 18:01:10.291-04,1,14,15
3852,37,2011-08-22 18:01:10.291-04,8,7,15
3853,38,2011-08-22 18:01:10.291-04,35,0,35
3854,39,2011-08-22 18:01:10.291-04,7,12,19
3855,40,2011-08-22 18:01:10.291-04,11,2,13
3856,41,2011-08-22 18:01:10.291-04,10,9,19
3857,42,2011-08-22 18:01:10.291-04,6,13,19
3858,43,2011-08-22 18:01:10.291-04,8,7,15
3859,44,2011-08-22 18:01:10.291-04,16,3,19
3860,45,2011-08-22 18:01:10.291-04,5,14,19
3861,46,2011-08-22 18:01:10.291-04,11,8,19
3862,47,2011-08-22 18:01:10.291-04,9,2,11
3863,48,2011-08-22 18:01:10.291-04,0,15,15
3864,49,2011-08-22 18:01:10.291-04,4,11,15
3865,50,2011-08-22 18:01:10.291-04,0,15,15
3866,51,2011-08-22 18:01:10.291-04,6,9,15
3867,52,2011-08-22 18:01:10.291-04,12,2,14
3868,53,2011-08-22 18:01:10.291-04,9,6,15
3869,55,2011-08-22 18:01:10.291-04,6,9,15
3870,56,2011-08-22 18:01:10.291-04,6,9,15
3871,57,2011-08-22 18:01:10.291-04,7,4,11
3872,3,2011-08-22 18:02:11.165-04,9,8,17
3873,5,2011-08-22 18:02:11.165-04,0,15,15
3874,6,2011-08-22 18:02:11.165-04,12,3,15
3875,8,2011-08-22 18:02:11.165-04,6,9,15
3876,9,2011-08-22 18:02:11.165-04,5,14,19
3877,10,2011-08-22 18:02:11.165-04,7,12,19
3878,11,2011-08-22 18:02:11.165-04,1,14,15
3879,12,2011-08-22 18:02:11.165-04,9,6,15
3880,13,2011-08-22 18:02:11.165-04,1,13,14
3881,14,2011-08-22 18:02:11.165-04,0,17,17
3882,15,2011-08-22 18:02:11.165-04,6,9,15
3883,16,2011-08-22 18:02:11.165-04,16,3,19
3884,17,2011-08-22 18:02:11.165-04,5,10,15
3885,18,2011-08-22 18:02:11.165-04,5,10,15
3886,20,2011-08-22 18:02:11.165-04,7,12,19
3887,21,2011-08-22 18:02:11.165-04,3,20,23
3888,22,2011-08-22 18:02:11.165-04,23,24,47
3889,23,2011-08-22 18:02:11.165-04,10,8,18
3890,24,2011-08-22 18:02:11.165-04,3,12,15
3891,25,2011-08-22 18:02:11.165-04,10,5,15
3892,26,2011-08-22 18:02:11.165-04,7,8,15
3893,27,2011-08-22 18:02:11.165-04,6,8,14
3894,30,2011-08-22 18:02:11.165-04,7,8,15
3895,31,2011-08-22 18:02:11.165-04,3,8,11
3896,32,2011-08-22 18:02:11.165-04,9,2,11
3897,33,2011-08-22 18:02:11.165-04,1,18,19
3898,34,2011-08-22 18:02:11.165-04,9,6,15
3899,35,2011-08-22 18:02:11.165-04,0,11,11
3900,36,2011-08-22 18:02:11.165-04,1,14,15
3901,37,2011-08-22 18:02:11.165-04,8,7,15
3902,38,2011-08-22 18:02:11.165-04,35,0,35
3903,39,2011-08-22 18:02:11.165-04,7,12,19
3904,40,2011-08-22 18:02:11.165-04,11,2,13
3905,41,2011-08-22 18:02:11.165-04,10,9,19
3906,42,2011-08-22 18:02:11.165-04,6,13,19
3907,43,2011-08-22 18:02:11.165-04,8,7,15
3908,44,2011-08-22 18:02:11.165-04,16,3,19
3909,45,2011-08-22 18:02:11.165-04,5,14,19
3910,46,2011-08-22 18:02:11.165-04,11,8,19
3911,47,2011-08-22 18:02:11.165-04,9,2,11
3912,48,2011-08-22 18:02:11.165-04,0,15,15
3913,49,2011-08-22 18:02:11.165-04,4,11,15
3914,50,2011-08-22 18:02:11.165-04,0,15,15
3915,51,2011-08-22 18:02:11.165-04,6,9,15
3916,52,2011-08-22 18:02:11.165-04,12,2,14
3917,53,2011-08-22 18:02:11.165-04,9,6,15
3918,55,2011-08-22 18:02:11.165-04,5,10,15
3919,56,2011-08-22 18:02:11.165-04,6,9,15
3920,57,2011-08-22 18:02:11.165-04,7,4,11
3921,3,2011-08-22 18:03:12.102-04,9,8,17
3922,5,2011-08-22 18:03:12.102-04,0,15,15
3923,6,2011-08-22 18:03:12.102-04,12,3,15
3924,8,2011-08-22 18:03:12.102-04,6,9,15
3925,9,2011-08-22 18:03:12.102-04,5,14,19
3926,10,2011-08-22 18:03:12.102-04,7,12,19
3927,11,2011-08-22 18:03:12.102-04,1,14,15
3928,12,2011-08-22 18:03:12.102-04,9,6,15
3929,13,2011-08-22 18:03:12.102-04,1,13,14
3930,14,2011-08-22 18:03:12.102-04,0,17,17
3931,15,2011-08-22 18:03:12.102-04,6,9,15
3932,16,2011-08-22 18:03:12.102-04,16,3,19
3933,17,2011-08-22 18:03:12.102-04,5,10,15
3934,18,2011-08-22 18:03:12.102-04,5,10,15
3935,20,2011-08-22 18:03:12.102-04,7,12,19
3936,21,2011-08-22 18:03:12.102-04,3,20,23
3937,22,2011-08-22 18:03:12.102-04,23,24,47
3938,23,2011-08-22 18:03:12.102-04,10,8,18
3939,24,2011-08-22 18:03:12.102-04,3,12,15
3940,25,2011-08-22 18:03:12.102-04,10,5,15
3941,26,2011-08-22 18:03:12.102-04,7,8,15
3942,27,2011-08-22 18:03:12.102-04,6,8,14
3943,30,2011-08-22 18:03:12.102-04,7,8,15
3944,31,2011-08-22 18:03:12.102-04,3,8,11
3945,32,2011-08-22 18:03:12.102-04,9,2,11
3946,33,2011-08-22 18:03:12.102-04,1,18,19
3947,34,2011-08-22 18:03:12.102-04,8,7,15
3948,35,2011-08-22 18:03:12.102-04,0,11,11
3949,36,2011-08-22 18:03:12.102-04,1,14,15
3950,37,2011-08-22 18:03:12.102-04,8,7,15
3951,38,2011-08-22 18:03:12.102-04,35,0,35
3952,39,2011-08-22 18:03:12.102-04,7,12,19
3953,40,2011-08-22 18:03:12.102-04,11,2,13
3954,41,2011-08-22 18:03:12.102-04,10,9,19
3955,42,2011-08-22 18:03:12.102-04,7,12,19
3956,43,2011-08-22 18:03:12.102-04,8,7,15
3957,44,2011-08-22 18:03:12.102-04,15,4,19
3958,45,2011-08-22 18:03:12.102-04,5,14,19
3959,46,2011-08-22 18:03:12.102-04,11,8,19
3960,47,2011-08-22 18:03:12.102-04,9,2,11
3961,48,2011-08-22 18:03:12.102-04,0,15,15
3962,49,2011-08-22 18:03:12.102-04,3,12,15
3963,50,2011-08-22 18:03:12.102-04,0,15,15
3964,51,2011-08-22 18:03:12.102-04,6,9,15
3965,52,2011-08-22 18:03:12.102-04,11,3,14
3966,53,2011-08-22 18:03:12.102-04,9,6,15
3967,55,2011-08-22 18:03:12.102-04,5,10,15
3968,56,2011-08-22 18:03:12.102-04,5,10,15
3969,57,2011-08-22 18:03:12.102-04,7,4,11
3970,3,2011-08-22 18:04:13.076-04,9,8,17
3971,5,2011-08-22 18:04:13.076-04,0,15,15
3972,6,2011-08-22 18:04:13.076-04,12,3,15
3973,8,2011-08-22 18:04:13.076-04,6,9,15
3974,9,2011-08-22 18:04:13.076-04,5,14,19
3975,10,2011-08-22 18:04:13.076-04,7,12,19
3976,11,2011-08-22 18:04:13.076-04,1,14,15
3977,12,2011-08-22 18:04:13.076-04,9,6,15
3978,13,2011-08-22 18:04:13.076-04,1,13,14
3979,14,2011-08-22 18:04:13.076-04,0,17,17
3980,15,2011-08-22 18:04:13.076-04,6,9,15
3981,16,2011-08-22 18:04:13.076-04,16,3,19
3982,17,2011-08-22 18:04:13.076-04,5,10,15
3983,18,2011-08-22 18:04:13.076-04,5,10,15
3984,20,2011-08-22 18:04:13.076-04,7,12,19
3985,21,2011-08-22 18:04:13.076-04,3,20,23
3986,22,2011-08-22 18:04:13.076-04,24,23,47
3987,23,2011-08-22 18:04:13.076-04,10,8,18
3988,24,2011-08-22 18:04:13.076-04,3,12,15
3989,25,2011-08-22 18:04:13.076-04,10,5,15
3990,26,2011-08-22 18:04:13.076-04,7,8,15
3991,27,2011-08-22 18:04:13.076-04,6,8,14
3992,30,2011-08-22 18:04:13.076-04,7,8,15
3993,31,2011-08-22 18:04:13.076-04,3,8,11
3994,32,2011-08-22 18:04:13.076-04,9,2,11
3995,33,2011-08-22 18:04:13.076-04,2,17,19
3996,34,2011-08-22 18:04:13.076-04,8,7,15
3997,35,2011-08-22 18:04:13.076-04,0,11,11
3998,36,2011-08-22 18:04:13.076-04,1,14,15
3999,37,2011-08-22 18:04:13.076-04,8,7,15
4000,38,2011-08-22 18:04:13.076-04,35,0,35
4001,39,2011-08-22 18:04:13.076-04,7,12,19
4002,40,2011-08-22 18:04:13.076-04,11,2,13
4003,41,2011-08-22 18:04:13.076-04,10,9,19
4004,42,2011-08-22 18:04:13.076-04,7,12,19
4005,43,2011-08-22 18:04:13.076-04,8,7,15
4006,44,2011-08-22 18:04:13.076-04,15,4,19
4007,45,2011-08-22 18:04:13.076-04,5,14,19
4008,46,2011-08-22 18:04:13.076-04,11,8,19
4009,47,2011-08-22 18:04:13.076-04,11,0,11
4010,48,2011-08-22 18:04:13.076-04,0,15,15
4011,49,2011-08-22 18:04:13.076-04,3,12,15
4012,50,2011-08-22 18:04:13.076-04,0,15,15
4013,51,2011-08-22 18:04:13.076-04,6,9,15
4014,52,2011-08-22 18:04:13.076-04,11,3,14
4015,53,2011-08-22 18:04:13.076-04,9,6,15
4016,55,2011-08-22 18:04:13.076-04,5,10,15
4017,56,2011-08-22 18:04:13.076-04,5,10,15
4018,57,2011-08-22 18:04:13.076-04,7,4,11
4019,3,2011-08-22 18:05:14.871-04,9,8,17
4020,5,2011-08-22 18:05:14.871-04,0,15,15
4021,6,2011-08-22 18:05:14.871-04,12,3,15
4022,8,2011-08-22 18:05:14.871-04,6,9,15
4023,9,2011-08-22 18:05:14.871-04,5,14,19
4024,10,2011-08-22 18:05:14.871-04,7,12,19
4025,11,2011-08-22 18:05:14.871-04,1,14,15
4026,12,2011-08-22 18:05:14.871-04,9,6,15
4027,13,2011-08-22 18:05:14.871-04,1,13,14
4028,14,2011-08-22 18:05:14.871-04,0,17,17
4029,15,2011-08-22 18:05:14.871-04,6,9,15
4030,16,2011-08-22 18:05:14.871-04,16,3,19
4031,17,2011-08-22 18:05:14.871-04,5,10,15
4032,18,2011-08-22 18:05:14.871-04,4,11,15
4033,20,2011-08-22 18:05:14.871-04,7,12,19
4034,21,2011-08-22 18:05:14.871-04,3,20,23
4035,22,2011-08-22 18:05:14.871-04,24,23,47
4036,23,2011-08-22 18:05:14.871-04,10,8,18
4037,24,2011-08-22 18:05:14.871-04,3,12,15
4038,25,2011-08-22 18:05:14.871-04,10,5,15
4039,26,2011-08-22 18:05:14.871-04,7,8,15
4040,27,2011-08-22 18:05:14.871-04,6,8,14
4041,30,2011-08-22 18:05:14.871-04,8,7,15
4042,31,2011-08-22 18:05:14.871-04,3,8,11
4043,32,2011-08-22 18:05:14.871-04,9,2,11
4044,33,2011-08-22 18:05:14.871-04,2,17,19
4045,34,2011-08-22 18:05:14.871-04,8,7,15
4046,35,2011-08-22 18:05:14.871-04,0,11,11
4047,36,2011-08-22 18:05:14.871-04,1,14,15
4048,37,2011-08-22 18:05:14.871-04,8,7,15
4049,38,2011-08-22 18:05:14.871-04,34,1,35
4050,39,2011-08-22 18:05:14.871-04,7,12,19
4051,40,2011-08-22 18:05:14.871-04,10,3,13
4052,41,2011-08-22 18:05:14.871-04,10,9,19
4053,42,2011-08-22 18:05:14.871-04,7,12,19
4054,43,2011-08-22 18:05:14.871-04,8,7,15
4055,44,2011-08-22 18:05:14.871-04,15,4,19
4056,45,2011-08-22 18:05:14.871-04,6,13,19
4057,46,2011-08-22 18:05:14.871-04,11,8,19
4058,47,2011-08-22 18:05:14.871-04,11,0,11
4059,48,2011-08-22 18:05:14.871-04,0,15,15
4060,49,2011-08-22 18:05:14.871-04,3,12,15
4061,50,2011-08-22 18:05:14.871-04,0,15,15
4062,51,2011-08-22 18:05:14.871-04,6,9,15
4063,52,2011-08-22 18:05:14.871-04,10,4,14
4064,53,2011-08-22 18:05:14.871-04,8,7,15
4065,55,2011-08-22 18:05:14.871-04,5,10,15
4066,56,2011-08-22 18:05:14.871-04,4,11,15
4067,57,2011-08-22 18:05:14.871-04,7,4,11
4068,3,2011-08-22 18:06:15.867-04,9,8,17
4069,5,2011-08-22 18:06:15.867-04,0,15,15
4070,6,2011-08-22 18:06:15.867-04,12,3,15
4071,8,2011-08-22 18:06:15.867-04,6,9,15
4072,9,2011-08-22 18:06:15.867-04,5,14,19
4073,10,2011-08-22 18:06:15.867-04,7,12,19
4074,11,2011-08-22 18:06:15.867-04,1,14,15
4075,12,2011-08-22 18:06:15.867-04,9,6,15
4076,13,2011-08-22 18:06:15.867-04,1,13,14
4077,14,2011-08-22 18:06:15.867-04,0,17,17
4078,15,2011-08-22 18:06:15.867-04,6,9,15
4079,16,2011-08-22 18:06:15.867-04,16,3,19
4080,17,2011-08-22 18:06:15.867-04,5,10,15
4081,18,2011-08-22 18:06:15.867-04,4,11,15
4082,20,2011-08-22 18:06:15.867-04,6,13,19
4083,21,2011-08-22 18:06:15.867-04,3,20,23
4084,22,2011-08-22 18:06:15.867-04,24,23,47
4085,23,2011-08-22 18:06:15.867-04,9,9,18
4086,24,2011-08-22 18:06:15.867-04,3,12,15
4087,25,2011-08-22 18:06:15.867-04,10,5,15
4088,26,2011-08-22 18:06:15.867-04,7,8,15
4089,27,2011-08-22 18:06:15.867-04,6,8,14
4090,30,2011-08-22 18:06:15.867-04,8,7,15
4091,31,2011-08-22 18:06:15.867-04,3,8,11
4092,32,2011-08-22 18:06:15.867-04,9,2,11
4093,33,2011-08-22 18:06:15.867-04,2,17,19
4094,34,2011-08-22 18:06:15.867-04,8,7,15
4095,35,2011-08-22 18:06:15.867-04,3,8,11
4096,36,2011-08-22 18:06:15.867-04,1,14,15
4097,37,2011-08-22 18:06:15.867-04,8,7,15
4098,38,2011-08-22 18:06:15.867-04,33,2,35
4099,39,2011-08-22 18:06:15.867-04,6,13,19
4100,40,2011-08-22 18:06:15.867-04,10,3,13
4101,41,2011-08-22 18:06:15.867-04,10,9,19
4102,42,2011-08-22 18:06:15.867-04,7,12,19
4103,43,2011-08-22 18:06:15.867-04,8,7,15
4104,44,2011-08-22 18:06:15.867-04,15,4,19
4105,45,2011-08-22 18:06:15.867-04,6,13,19
4106,46,2011-08-22 18:06:15.867-04,11,8,19
4107,47,2011-08-22 18:06:15.867-04,11,0,11
4108,48,2011-08-22 18:06:15.867-04,0,15,15
4109,49,2011-08-22 18:06:15.867-04,3,12,15
4110,50,2011-08-22 18:06:15.867-04,0,15,15
4111,51,2011-08-22 18:06:15.867-04,6,9,15
4112,52,2011-08-22 18:06:15.867-04,10,4,14
4113,53,2011-08-22 18:06:15.867-04,8,7,15
4114,55,2011-08-22 18:06:15.867-04,5,10,15
4115,56,2011-08-22 18:06:15.867-04,4,11,15
4116,57,2011-08-22 18:06:15.867-04,7,4,11
4117,3,2011-08-22 18:07:16.843-04,9,8,17
4118,5,2011-08-22 18:07:16.843-04,0,15,15
4119,6,2011-08-22 18:07:16.843-04,12,3,15
4120,8,2011-08-22 18:07:16.843-04,6,9,15
4121,9,2011-08-22 18:07:16.843-04,5,14,19
4122,10,2011-08-22 18:07:16.843-04,6,13,19
4123,11,2011-08-22 18:07:16.843-04,0,15,15
4124,12,2011-08-22 18:07:16.843-04,9,6,15
4125,13,2011-08-22 18:07:16.843-04,1,13,14
4126,14,2011-08-22 18:07:16.843-04,0,17,17
4127,15,2011-08-22 18:07:16.843-04,6,9,15
4128,16,2011-08-22 18:07:16.843-04,16,3,19
4129,17,2011-08-22 18:07:16.843-04,5,10,15
4130,18,2011-08-22 18:07:16.843-04,4,11,15
4131,20,2011-08-22 18:07:16.843-04,6,13,19
4132,21,2011-08-22 18:07:16.843-04,3,20,23
4133,22,2011-08-22 18:07:16.843-04,24,23,47
4134,23,2011-08-22 18:07:16.843-04,6,12,18
4135,24,2011-08-22 18:07:16.843-04,3,12,15
4136,25,2011-08-22 18:07:16.843-04,10,5,15
4137,26,2011-08-22 18:07:16.843-04,7,8,15
4138,27,2011-08-22 18:07:16.843-04,6,8,14
4139,30,2011-08-22 18:07:16.843-04,8,7,15
4140,31,2011-08-22 18:07:16.843-04,5,6,11
4141,32,2011-08-22 18:07:16.843-04,9,2,11
4142,33,2011-08-22 18:07:16.843-04,2,17,19
4143,34,2011-08-22 18:07:16.843-04,8,7,15
4144,35,2011-08-22 18:07:16.843-04,3,8,11
4145,36,2011-08-22 18:07:16.843-04,1,14,15
4146,37,2011-08-22 18:07:16.843-04,8,7,15
4147,38,2011-08-22 18:07:16.843-04,32,3,35
4148,39,2011-08-22 18:07:16.843-04,8,11,19
4149,40,2011-08-22 18:07:16.843-04,10,3,13
4150,41,2011-08-22 18:07:16.843-04,10,9,19
4151,42,2011-08-22 18:07:16.843-04,6,13,19
4152,43,2011-08-22 18:07:16.843-04,6,9,15
4153,44,2011-08-22 18:07:16.843-04,15,4,19
4154,45,2011-08-22 18:07:16.843-04,6,13,19
4155,46,2011-08-22 18:07:16.843-04,11,8,19
4156,47,2011-08-22 18:07:16.843-04,11,0,11
4157,48,2011-08-22 18:07:16.843-04,0,15,15
4158,49,2011-08-22 18:07:16.843-04,3,12,15
4159,50,2011-08-22 18:07:16.843-04,0,15,15
4160,51,2011-08-22 18:07:16.843-04,6,9,15
4161,52,2011-08-22 18:07:16.843-04,10,4,14
4162,53,2011-08-22 18:07:16.843-04,8,7,15
4163,55,2011-08-22 18:07:16.843-04,5,10,15
4164,56,2011-08-22 18:07:16.843-04,4,11,15
4165,57,2011-08-22 18:07:16.843-04,7,4,11
4166,3,2011-08-22 18:08:17.839-04,9,8,17
4167,5,2011-08-22 18:08:17.839-04,0,15,15
4168,6,2011-08-22 18:08:17.839-04,12,3,15
4169,8,2011-08-22 18:08:17.839-04,6,9,15
4170,9,2011-08-22 18:08:17.839-04,5,14,19
4171,10,2011-08-22 18:08:17.839-04,6,13,19
4172,11,2011-08-22 18:08:17.839-04,0,15,15
4173,12,2011-08-22 18:08:17.839-04,9,6,15
4174,13,2011-08-22 18:08:17.839-04,1,13,14
4175,14,2011-08-22 18:08:17.839-04,0,17,17
4176,15,2011-08-22 18:08:17.839-04,6,9,15
4177,16,2011-08-22 18:08:17.839-04,16,3,19
4178,17,2011-08-22 18:08:17.839-04,5,10,15
4179,18,2011-08-22 18:08:17.839-04,4,11,15
4180,20,2011-08-22 18:08:17.839-04,6,13,19
4181,21,2011-08-22 18:08:17.839-04,2,21,23
4182,22,2011-08-22 18:08:17.839-04,24,23,47
4183,23,2011-08-22 18:08:17.839-04,7,11,18
4184,24,2011-08-22 18:08:17.839-04,3,12,15
4185,25,2011-08-22 18:08:17.839-04,10,5,15
4186,26,2011-08-22 18:08:17.839-04,7,8,15
4187,27,2011-08-22 18:08:17.839-04,6,8,14
4188,30,2011-08-22 18:08:17.839-04,8,7,15
4189,31,2011-08-22 18:08:17.839-04,5,6,11
4190,32,2011-08-22 18:08:17.839-04,9,2,11
4191,33,2011-08-22 18:08:17.839-04,2,17,19
4192,34,2011-08-22 18:08:17.839-04,8,7,15
4193,35,2011-08-22 18:08:17.839-04,3,8,11
4194,36,2011-08-22 18:08:17.839-04,3,12,15
4195,37,2011-08-22 18:08:17.839-04,8,7,15
4196,38,2011-08-22 18:08:17.839-04,32,3,35
4197,39,2011-08-22 18:08:17.839-04,8,11,19
4198,40,2011-08-22 18:08:17.839-04,10,3,13
4199,41,2011-08-22 18:08:17.839-04,10,9,19
4200,42,2011-08-22 18:08:17.839-04,6,13,19
4201,43,2011-08-22 18:08:17.839-04,5,10,15
4202,44,2011-08-22 18:08:17.839-04,15,4,19
4203,45,2011-08-22 18:08:17.839-04,5,14,19
4204,46,2011-08-22 18:08:17.839-04,11,8,19
4205,47,2011-08-22 18:08:17.839-04,11,0,11
4206,48,2011-08-22 18:08:17.839-04,0,15,15
4207,49,2011-08-22 18:08:17.839-04,3,12,15
4208,50,2011-08-22 18:08:17.839-04,0,15,15
4209,51,2011-08-22 18:08:17.839-04,6,9,15
4210,52,2011-08-22 18:08:17.839-04,10,4,14
4211,53,2011-08-22 18:08:17.839-04,8,7,15
4212,55,2011-08-22 18:08:17.839-04,5,10,15
4213,56,2011-08-22 18:08:17.839-04,4,11,15
4214,57,2011-08-22 18:08:17.839-04,7,4,11
4215,3,2011-08-22 18:09:18.787-04,9,8,17
4216,5,2011-08-22 18:09:18.787-04,0,15,15
4217,6,2011-08-22 18:09:18.787-04,12,3,15
4218,8,2011-08-22 18:09:18.787-04,6,9,15
4219,9,2011-08-22 18:09:18.787-04,5,14,19
4220,10,2011-08-22 18:09:18.787-04,6,13,19
4221,11,2011-08-22 18:09:18.787-04,0,15,15
4222,12,2011-08-22 18:09:18.787-04,9,6,15
4223,13,2011-08-22 18:09:18.787-04,1,13,14
4224,14,2011-08-22 18:09:18.787-04,0,17,17
4225,15,2011-08-22 18:09:18.787-04,6,9,15
4226,16,2011-08-22 18:09:18.787-04,16,3,19
4227,17,2011-08-22 18:09:18.787-04,5,10,15
4228,18,2011-08-22 18:09:18.787-04,4,11,15
4229,20,2011-08-22 18:09:18.787-04,6,13,19
4230,21,2011-08-22 18:09:18.787-04,2,21,23
4231,22,2011-08-22 18:09:18.787-04,24,23,47
4232,23,2011-08-22 18:09:18.787-04,7,11,18
4233,24,2011-08-22 18:09:18.787-04,3,12,15
4234,25,2011-08-22 18:09:18.787-04,10,5,15
4235,26,2011-08-22 18:09:18.787-04,7,8,15
4236,27,2011-08-22 18:09:18.787-04,6,8,14
4237,30,2011-08-22 18:09:18.787-04,8,7,15
4238,31,2011-08-22 18:09:18.787-04,5,6,11
4239,32,2011-08-22 18:09:18.787-04,9,2,11
4240,33,2011-08-22 18:09:18.787-04,2,17,19
4241,34,2011-08-22 18:09:18.787-04,8,7,15
4242,35,2011-08-22 18:09:18.787-04,3,8,11
4243,36,2011-08-22 18:09:18.787-04,3,12,15
4244,37,2011-08-22 18:09:18.787-04,8,7,15
4245,38,2011-08-22 18:09:18.787-04,30,5,35
4246,39,2011-08-22 18:09:18.787-04,9,10,19
4247,40,2011-08-22 18:09:18.787-04,9,4,13
4248,41,2011-08-22 18:09:18.787-04,10,9,19
4249,42,2011-08-22 18:09:18.787-04,6,13,19
4250,43,2011-08-22 18:09:18.787-04,5,10,15
4251,44,2011-08-22 18:09:18.787-04,15,4,19
4252,45,2011-08-22 18:09:18.787-04,5,14,19
4253,46,2011-08-22 18:09:18.787-04,11,8,19
4254,47,2011-08-22 18:09:18.787-04,11,0,11
4255,48,2011-08-22 18:09:18.787-04,0,15,15
4256,49,2011-08-22 18:09:18.787-04,3,12,15
4257,50,2011-08-22 18:09:18.787-04,0,15,15
4258,51,2011-08-22 18:09:18.787-04,6,9,15
4259,52,2011-08-22 18:09:18.787-04,10,4,14
4260,53,2011-08-22 18:09:18.787-04,9,6,15
4261,55,2011-08-22 18:09:18.787-04,5,10,15
4262,56,2011-08-22 18:09:18.787-04,5,10,15
4263,57,2011-08-22 18:09:18.787-04,7,4,11
4264,3,2011-08-22 18:10:19.668-04,9,8,17
4265,5,2011-08-22 18:10:19.668-04,0,15,15
4266,6,2011-08-22 18:10:19.668-04,12,3,15
4267,8,2011-08-22 18:10:19.668-04,6,9,15
4268,9,2011-08-22 18:10:19.668-04,5,14,19
4269,10,2011-08-22 18:10:19.668-04,6,13,19
4270,11,2011-08-22 18:10:19.668-04,0,15,15
4271,12,2011-08-22 18:10:19.668-04,9,6,15
4272,13,2011-08-22 18:10:19.668-04,1,13,14
4273,14,2011-08-22 18:10:19.668-04,0,17,17
4274,15,2011-08-22 18:10:19.668-04,6,9,15
4275,16,2011-08-22 18:10:19.668-04,16,3,19
4276,17,2011-08-22 18:10:19.668-04,5,10,15
4277,18,2011-08-22 18:10:19.668-04,5,10,15
4278,20,2011-08-22 18:10:19.668-04,6,13,19
4279,21,2011-08-22 18:10:19.668-04,2,21,23
4280,22,2011-08-22 18:10:19.668-04,23,24,47
4281,23,2011-08-22 18:10:19.668-04,7,11,18
4282,24,2011-08-22 18:10:19.668-04,3,12,15
4283,25,2011-08-22 18:10:19.668-04,10,5,15
4284,26,2011-08-22 18:10:19.668-04,7,8,15
4285,27,2011-08-22 18:10:19.668-04,6,8,14
4286,30,2011-08-22 18:10:19.668-04,8,7,15
4287,31,2011-08-22 18:10:19.668-04,5,6,11
4288,32,2011-08-22 18:10:19.668-04,9,2,11
4289,33,2011-08-22 18:10:19.668-04,2,17,19
4290,34,2011-08-22 18:10:19.668-04,8,7,15
4291,35,2011-08-22 18:10:19.668-04,3,8,11
4292,36,2011-08-22 18:10:19.668-04,3,12,15
4293,37,2011-08-22 18:10:19.668-04,8,7,15
4294,38,2011-08-22 18:10:19.668-04,28,7,35
4295,39,2011-08-22 18:10:19.668-04,9,10,19
4296,40,2011-08-22 18:10:19.668-04,10,3,13
4297,41,2011-08-22 18:10:19.668-04,10,9,19
4298,42,2011-08-22 18:10:19.668-04,7,12,19
4299,43,2011-08-22 18:10:19.668-04,5,10,15
4300,44,2011-08-22 18:10:19.668-04,15,4,19
4301,45,2011-08-22 18:10:19.668-04,5,14,19
4302,46,2011-08-22 18:10:19.668-04,11,8,19
4303,47,2011-08-22 18:10:19.668-04,11,0,11
4304,48,2011-08-22 18:10:19.668-04,0,15,15
4305,49,2011-08-22 18:10:19.668-04,3,12,15
4306,50,2011-08-22 18:10:19.668-04,0,15,15
4307,51,2011-08-22 18:10:19.668-04,6,9,15
4308,52,2011-08-22 18:10:19.668-04,10,4,14
4309,53,2011-08-22 18:10:19.668-04,9,6,15
4310,55,2011-08-22 18:10:19.668-04,5,10,15
4311,56,2011-08-22 18:10:19.668-04,4,11,15
4312,57,2011-08-22 18:10:19.668-04,7,4,11
4313,3,2011-08-22 18:11:20.859-04,9,8,17
4314,5,2011-08-22 18:11:20.859-04,0,15,15
4315,6,2011-08-22 18:11:20.859-04,11,4,15
4316,8,2011-08-22 18:11:20.859-04,6,9,15
4317,9,2011-08-22 18:11:20.859-04,5,14,19
4318,10,2011-08-22 18:11:20.859-04,6,13,19
4319,11,2011-08-22 18:11:20.859-04,0,15,15
4320,12,2011-08-22 18:11:20.859-04,9,6,15
4321,13,2011-08-22 18:11:20.859-04,1,13,14
4322,14,2011-08-22 18:11:20.859-04,0,17,17
4323,15,2011-08-22 18:11:20.859-04,6,9,15
4324,16,2011-08-22 18:11:20.859-04,16,3,19
4325,17,2011-08-22 18:11:20.859-04,5,10,15
4326,18,2011-08-22 18:11:20.859-04,5,10,15
4327,20,2011-08-22 18:11:20.859-04,6,13,19
4328,21,2011-08-22 18:11:20.859-04,2,21,23
4329,22,2011-08-22 18:11:20.859-04,23,24,47
4330,23,2011-08-22 18:11:20.859-04,7,11,18
4331,24,2011-08-22 18:11:20.859-04,3,12,15
4332,25,2011-08-22 18:11:20.859-04,10,5,15
4333,26,2011-08-22 18:11:20.859-04,7,8,15
4334,27,2011-08-22 18:11:20.859-04,6,8,14
4335,30,2011-08-22 18:11:20.859-04,8,7,15
4336,31,2011-08-22 18:11:20.859-04,5,6,11
4337,32,2011-08-22 18:11:20.859-04,9,2,11
4338,33,2011-08-22 18:11:20.859-04,2,17,19
4339,34,2011-08-22 18:11:20.859-04,8,7,15
4340,35,2011-08-22 18:11:20.859-04,3,8,11
4341,36,2011-08-22 18:11:20.859-04,3,12,15
4342,37,2011-08-22 18:11:20.859-04,8,7,15
4343,38,2011-08-22 18:11:20.859-04,27,8,35
4344,39,2011-08-22 18:11:20.859-04,9,10,19
4345,40,2011-08-22 18:11:20.859-04,12,1,13
4346,41,2011-08-22 18:11:20.859-04,10,9,19
4347,42,2011-08-22 18:11:20.859-04,7,12,19
4348,43,2011-08-22 18:11:20.859-04,3,12,15
4349,44,2011-08-22 18:11:20.859-04,15,4,19
4350,45,2011-08-22 18:11:20.859-04,5,14,19
4351,46,2011-08-22 18:11:20.859-04,11,8,19
4352,47,2011-08-22 18:11:20.859-04,11,0,11
4353,48,2011-08-22 18:11:20.859-04,0,15,15
4354,49,2011-08-22 18:11:20.859-04,3,12,15
4355,50,2011-08-22 18:11:20.859-04,0,15,15
4356,51,2011-08-22 18:11:20.859-04,6,9,15
4357,52,2011-08-22 18:11:20.859-04,10,4,14
4358,53,2011-08-22 18:11:20.859-04,9,6,15
4359,55,2011-08-22 18:11:20.859-04,5,10,15
4360,56,2011-08-22 18:11:20.859-04,4,11,15
4361,57,2011-08-22 18:11:20.859-04,7,4,11
4362,3,2011-08-22 18:12:21.719-04,9,8,17
4363,5,2011-08-22 18:12:21.719-04,0,15,15
4364,6,2011-08-22 18:12:21.719-04,10,5,15
4365,8,2011-08-22 18:12:21.719-04,6,9,15
4366,9,2011-08-22 18:12:21.719-04,5,14,19
4367,10,2011-08-22 18:12:21.719-04,6,13,19
4368,11,2011-08-22 18:12:21.719-04,0,15,15
4369,12,2011-08-22 18:12:21.719-04,9,6,15
4370,13,2011-08-22 18:12:21.719-04,1,13,14
4371,14,2011-08-22 18:12:21.719-04,0,17,17
4372,15,2011-08-22 18:12:21.719-04,6,9,15
4373,16,2011-08-22 18:12:21.719-04,17,2,19
4374,17,2011-08-22 18:12:21.719-04,5,10,15
4375,18,2011-08-22 18:12:21.719-04,5,10,15
4376,20,2011-08-22 18:12:21.719-04,6,13,19
4377,21,2011-08-22 18:12:21.719-04,4,19,23
4378,22,2011-08-22 18:12:21.719-04,23,24,47
4379,23,2011-08-22 18:12:21.719-04,7,11,18
4380,24,2011-08-22 18:12:21.719-04,4,11,15
4381,25,2011-08-22 18:12:21.719-04,10,5,15
4382,26,2011-08-22 18:12:21.719-04,7,8,15
4383,27,2011-08-22 18:12:21.719-04,6,8,14
4384,30,2011-08-22 18:12:21.719-04,8,7,15
4385,31,2011-08-22 18:12:21.719-04,5,6,11
4386,32,2011-08-22 18:12:21.719-04,9,2,11
4387,33,2011-08-22 18:12:21.719-04,2,17,19
4388,34,2011-08-22 18:12:21.719-04,8,7,15
4389,35,2011-08-22 18:12:21.719-04,3,8,11
4390,36,2011-08-22 18:12:21.719-04,4,11,15
4391,37,2011-08-22 18:12:21.719-04,8,7,15
4392,38,2011-08-22 18:12:21.719-04,27,8,35
4393,39,2011-08-22 18:12:21.719-04,9,10,19
4394,40,2011-08-22 18:12:21.719-04,12,1,13
4395,41,2011-08-22 18:12:21.719-04,10,9,19
4396,42,2011-08-22 18:12:21.719-04,7,12,19
4397,43,2011-08-22 18:12:21.719-04,3,12,15
4398,44,2011-08-22 18:12:21.719-04,15,4,19
4399,45,2011-08-22 18:12:21.719-04,5,14,19
4400,46,2011-08-22 18:12:21.719-04,11,8,19
4401,47,2011-08-22 18:12:21.719-04,11,0,11
4402,48,2011-08-22 18:12:21.719-04,0,15,15
4403,49,2011-08-22 18:12:21.719-04,3,12,15
4404,50,2011-08-22 18:12:21.719-04,0,15,15
4405,51,2011-08-22 18:12:21.719-04,6,9,15
4406,52,2011-08-22 18:12:21.719-04,10,4,14
4407,53,2011-08-22 18:12:21.719-04,9,6,15
4408,55,2011-08-22 18:12:21.719-04,5,10,15
4409,56,2011-08-22 18:12:21.719-04,4,11,15
4410,57,2011-08-22 18:12:21.719-04,7,4,11
4411,3,2011-08-22 18:13:22.604-04,9,8,17
4412,5,2011-08-22 18:13:22.604-04,0,15,15
4413,6,2011-08-22 18:13:22.604-04,10,5,15
4414,8,2011-08-22 18:13:22.604-04,6,9,15
4415,9,2011-08-22 18:13:22.604-04,5,14,19
4416,10,2011-08-22 18:13:22.604-04,6,13,19
4417,11,2011-08-22 18:13:22.604-04,0,15,15
4418,12,2011-08-22 18:13:22.604-04,9,6,15
4419,13,2011-08-22 18:13:22.604-04,1,13,14
4420,14,2011-08-22 18:13:22.604-04,0,17,17
4421,15,2011-08-22 18:13:22.604-04,6,9,15
4422,16,2011-08-22 18:13:22.604-04,15,4,19
4423,17,2011-08-22 18:13:22.604-04,5,10,15
4424,18,2011-08-22 18:13:22.604-04,5,10,15
4425,20,2011-08-22 18:13:22.604-04,6,13,19
4426,21,2011-08-22 18:13:22.604-04,6,17,23
4427,22,2011-08-22 18:13:22.604-04,23,24,47
4428,23,2011-08-22 18:13:22.604-04,6,12,18
4429,24,2011-08-22 18:13:22.604-04,4,11,15
4430,25,2011-08-22 18:13:22.604-04,10,5,15
4431,26,2011-08-22 18:13:22.604-04,7,8,15
4432,27,2011-08-22 18:13:22.604-04,6,8,14
4433,30,2011-08-22 18:13:22.604-04,8,7,15
4434,31,2011-08-22 18:13:22.604-04,5,6,11
4435,32,2011-08-22 18:13:22.604-04,10,1,11
4436,33,2011-08-22 18:13:22.604-04,2,17,19
4437,34,2011-08-22 18:13:22.604-04,8,7,15
4438,35,2011-08-22 18:13:22.604-04,3,8,11
4439,36,2011-08-22 18:13:22.604-04,4,11,15
4440,37,2011-08-22 18:13:22.604-04,8,7,15
4441,38,2011-08-22 18:13:22.604-04,27,8,35
4442,39,2011-08-22 18:13:22.604-04,9,10,19
4443,40,2011-08-22 18:13:22.604-04,13,0,13
4444,41,2011-08-22 18:13:22.604-04,10,9,19
4445,42,2011-08-22 18:13:22.604-04,7,12,19
4446,43,2011-08-22 18:13:22.604-04,3,12,15
4447,44,2011-08-22 18:13:22.604-04,15,4,19
4448,45,2011-08-22 18:13:22.604-04,5,14,19
4449,46,2011-08-22 18:13:22.604-04,11,8,19
4450,47,2011-08-22 18:13:22.604-04,11,0,11
4451,48,2011-08-22 18:13:22.604-04,0,15,15
4452,49,2011-08-22 18:13:22.604-04,2,13,15
4453,50,2011-08-22 18:13:22.604-04,0,15,15
4454,51,2011-08-22 18:13:22.604-04,6,9,15
4455,52,2011-08-22 18:13:22.604-04,10,4,14
4456,53,2011-08-22 18:13:22.604-04,9,6,15
4457,55,2011-08-22 18:13:22.604-04,5,10,15
4458,56,2011-08-22 18:13:22.604-04,3,12,15
4459,57,2011-08-22 18:13:22.604-04,7,4,11
4460,3,2011-08-22 18:14:23.532-04,9,8,17
4461,5,2011-08-22 18:14:23.532-04,0,15,15
4462,6,2011-08-22 18:14:23.532-04,10,5,15
4463,8,2011-08-22 18:14:23.532-04,6,9,15
4464,9,2011-08-22 18:14:23.532-04,5,14,19
4465,10,2011-08-22 18:14:23.532-04,6,13,19
4466,11,2011-08-22 18:14:23.532-04,0,15,15
4467,12,2011-08-22 18:14:23.532-04,9,6,15
4468,13,2011-08-22 18:14:23.532-04,1,13,14
4469,14,2011-08-22 18:14:23.532-04,0,17,17
4470,15,2011-08-22 18:14:23.532-04,6,9,15
4471,16,2011-08-22 18:14:23.532-04,15,4,19
4472,17,2011-08-22 18:14:23.532-04,5,10,15
4473,18,2011-08-22 18:14:23.532-04,5,10,15
4474,20,2011-08-22 18:14:23.532-04,6,13,19
4475,21,2011-08-22 18:14:23.532-04,5,18,23
4476,22,2011-08-22 18:14:23.532-04,23,24,47
4477,23,2011-08-22 18:14:23.532-04,6,12,18
4478,24,2011-08-22 18:14:23.532-04,4,11,15
4479,25,2011-08-22 18:14:23.532-04,10,5,15
4480,26,2011-08-22 18:14:23.532-04,7,8,15
4481,27,2011-08-22 18:14:23.532-04,6,8,14
4482,30,2011-08-22 18:14:23.532-04,8,7,15
4483,31,2011-08-22 18:14:23.532-04,5,6,11
4484,32,2011-08-22 18:14:23.532-04,10,1,11
4485,33,2011-08-22 18:14:23.532-04,2,17,19
4486,34,2011-08-22 18:14:23.532-04,8,7,15
4487,35,2011-08-22 18:14:23.532-04,3,8,11
4488,36,2011-08-22 18:14:23.532-04,4,11,15
4489,37,2011-08-22 18:14:23.532-04,8,7,15
4490,38,2011-08-22 18:14:23.532-04,27,8,35
4491,39,2011-08-22 18:14:23.532-04,9,10,19
4492,40,2011-08-22 18:14:23.532-04,13,0,13
4493,41,2011-08-22 18:14:23.532-04,11,8,19
4494,42,2011-08-22 18:14:23.532-04,7,12,19
4495,43,2011-08-22 18:14:23.532-04,3,12,15
4496,44,2011-08-22 18:14:23.532-04,15,4,19
4497,45,2011-08-22 18:14:23.532-04,5,14,19
4498,46,2011-08-22 18:14:23.532-04,11,8,19
4499,47,2011-08-22 18:14:23.532-04,11,0,11
4500,48,2011-08-22 18:14:23.532-04,0,15,15
4501,49,2011-08-22 18:14:23.532-04,2,13,15
4502,50,2011-08-22 18:14:23.532-04,0,15,15
4503,51,2011-08-22 18:14:23.532-04,6,9,15
4504,52,2011-08-22 18:14:23.532-04,10,4,14
4505,53,2011-08-22 18:14:23.532-04,9,6,15
4506,55,2011-08-22 18:14:23.532-04,5,10,15
4507,56,2011-08-22 18:14:23.532-04,3,12,15
4508,57,2011-08-22 18:14:23.532-04,7,4,11
4509,3,2011-08-22 18:15:24.455-04,9,8,17
4510,5,2011-08-22 18:15:24.455-04,0,15,15
4511,6,2011-08-22 18:15:24.455-04,10,5,15
4512,8,2011-08-22 18:15:24.455-04,6,9,15
4513,9,2011-08-22 18:15:24.455-04,5,14,19
4514,10,2011-08-22 18:15:24.455-04,5,14,19
4515,11,2011-08-22 18:15:24.455-04,0,15,15
4516,12,2011-08-22 18:15:24.455-04,9,6,15
4517,13,2011-08-22 18:15:24.455-04,1,13,14
4518,14,2011-08-22 18:15:24.455-04,0,17,17
4519,15,2011-08-22 18:15:24.455-04,6,9,15
4520,16,2011-08-22 18:15:24.455-04,15,4,19
4521,17,2011-08-22 18:15:24.455-04,5,10,15
4522,18,2011-08-22 18:15:24.455-04,5,10,15
4523,20,2011-08-22 18:15:24.455-04,6,13,19
4524,21,2011-08-22 18:15:24.455-04,5,18,23
4525,22,2011-08-22 18:15:24.455-04,23,24,47
4526,23,2011-08-22 18:15:24.455-04,6,12,18
4527,24,2011-08-22 18:15:24.455-04,4,11,15
4528,25,2011-08-22 18:15:24.455-04,11,4,15
4529,26,2011-08-22 18:15:24.455-04,7,8,15
4530,27,2011-08-22 18:15:24.455-04,6,8,14
4531,30,2011-08-22 18:15:24.455-04,8,7,15
4532,31,2011-08-22 18:15:24.455-04,5,6,11
4533,32,2011-08-22 18:15:24.455-04,10,1,11
4534,33,2011-08-22 18:15:24.455-04,2,17,19
4535,34,2011-08-22 18:15:24.455-04,8,7,15
4536,35,2011-08-22 18:15:24.455-04,3,8,11
4537,36,2011-08-22 18:15:24.455-04,4,11,15
4538,37,2011-08-22 18:15:24.455-04,8,7,15
4539,38,2011-08-22 18:15:24.455-04,28,7,35
4540,39,2011-08-22 18:15:24.455-04,9,10,19
4541,40,2011-08-22 18:15:24.455-04,13,0,13
4542,41,2011-08-22 18:15:24.455-04,9,10,19
4543,42,2011-08-22 18:15:24.455-04,7,12,19
4544,43,2011-08-22 18:15:24.455-04,3,12,15
4545,44,2011-08-22 18:15:24.455-04,15,4,19
4546,45,2011-08-22 18:15:24.455-04,5,14,19
4547,46,2011-08-22 18:15:24.455-04,13,6,19
4548,47,2011-08-22 18:15:24.455-04,11,0,11
4549,48,2011-08-22 18:15:24.455-04,0,15,15
4550,49,2011-08-22 18:15:24.455-04,1,14,15
4551,50,2011-08-22 18:15:24.455-04,0,15,15
4552,51,2011-08-22 18:15:24.455-04,6,9,15
4553,52,2011-08-22 18:15:24.455-04,10,4,14
4554,53,2011-08-22 18:15:24.455-04,9,6,15
4555,55,2011-08-22 18:15:24.455-04,5,10,15
4556,56,2011-08-22 18:15:24.455-04,3,12,15
4557,57,2011-08-22 18:15:24.455-04,6,5,11
4558,3,2011-08-22 18:16:25.476-04,9,8,17
4559,5,2011-08-22 18:16:25.476-04,0,15,15
4560,6,2011-08-22 18:16:25.476-04,10,5,15
4561,8,2011-08-22 18:16:25.476-04,6,9,15
4562,9,2011-08-22 18:16:25.476-04,6,13,19
4563,10,2011-08-22 18:16:25.476-04,5,14,19
4564,11,2011-08-22 18:16:25.476-04,0,15,15
4565,12,2011-08-22 18:16:25.476-04,9,6,15
4566,13,2011-08-22 18:16:25.476-04,1,13,14
4567,14,2011-08-22 18:16:25.476-04,0,17,17
4568,15,2011-08-22 18:16:25.476-04,6,9,15
4569,16,2011-08-22 18:16:25.476-04,15,4,19
4570,17,2011-08-22 18:16:25.476-04,5,10,15
4571,18,2011-08-22 18:16:25.476-04,5,10,15
4572,20,2011-08-22 18:16:25.476-04,6,13,19
4573,21,2011-08-22 18:16:25.476-04,5,18,23
4574,22,2011-08-22 18:16:25.476-04,23,24,47
4575,23,2011-08-22 18:16:25.476-04,6,12,18
4576,24,2011-08-22 18:16:25.476-04,4,11,15
4577,25,2011-08-22 18:16:25.476-04,11,4,15
4578,26,2011-08-22 18:16:25.476-04,7,8,15
4579,27,2011-08-22 18:16:25.476-04,6,8,14
4580,30,2011-08-22 18:16:25.476-04,8,7,15
4581,31,2011-08-22 18:16:25.476-04,6,5,11
4582,32,2011-08-22 18:16:25.476-04,10,1,11
4583,33,2011-08-22 18:16:25.476-04,3,16,19
4584,34,2011-08-22 18:16:25.476-04,8,7,15
4585,35,2011-08-22 18:16:25.476-04,3,8,11
4586,36,2011-08-22 18:16:25.476-04,5,10,15
4587,37,2011-08-22 18:16:25.476-04,8,7,15
4588,38,2011-08-22 18:16:25.476-04,28,7,35
4589,39,2011-08-22 18:16:25.476-04,9,10,19
4590,40,2011-08-22 18:16:25.476-04,13,0,13
4591,41,2011-08-22 18:16:25.476-04,9,10,19
4592,42,2011-08-22 18:16:25.476-04,7,12,19
4593,43,2011-08-22 18:16:25.476-04,3,12,15
4594,44,2011-08-22 18:16:25.476-04,14,5,19
4595,45,2011-08-22 18:16:25.476-04,5,14,19
4596,46,2011-08-22 18:16:25.476-04,13,6,19
4597,47,2011-08-22 18:16:25.476-04,9,2,11
4598,48,2011-08-22 18:16:25.476-04,0,15,15
4599,49,2011-08-22 18:16:25.476-04,1,14,15
4600,50,2011-08-22 18:16:25.476-04,0,15,15
4601,51,2011-08-22 18:16:25.476-04,6,9,15
4602,52,2011-08-22 18:16:25.476-04,10,4,14
4603,53,2011-08-22 18:16:25.476-04,9,6,15
4604,55,2011-08-22 18:16:25.476-04,5,10,15
4605,56,2011-08-22 18:16:25.476-04,3,12,15
4606,57,2011-08-22 18:16:25.476-04,7,4,11
4607,3,2011-08-22 18:17:26.356-04,9,8,17
4608,5,2011-08-22 18:17:26.356-04,0,15,15
4609,6,2011-08-22 18:17:26.356-04,10,5,15
4610,8,2011-08-22 18:17:26.356-04,6,9,15
4611,9,2011-08-22 18:17:26.356-04,7,12,19
4612,10,2011-08-22 18:17:26.356-04,5,14,19
4613,11,2011-08-22 18:17:26.356-04,0,15,15
4614,12,2011-08-22 18:17:26.356-04,9,6,15
4615,13,2011-08-22 18:17:26.356-04,1,13,14
4616,14,2011-08-22 18:17:26.356-04,0,17,17
4617,15,2011-08-22 18:17:26.356-04,6,9,15
4618,16,2011-08-22 18:17:26.356-04,15,4,19
4619,17,2011-08-22 18:17:26.356-04,5,10,15
4620,18,2011-08-22 18:17:26.356-04,5,10,15
4621,20,2011-08-22 18:17:26.356-04,6,13,19
4622,21,2011-08-22 18:17:26.356-04,5,18,23
4623,22,2011-08-22 18:17:26.356-04,23,24,47
4624,23,2011-08-22 18:17:26.356-04,6,12,18
4625,24,2011-08-22 18:17:26.356-04,4,11,15
4626,25,2011-08-22 18:17:26.356-04,11,4,15
4627,26,2011-08-22 18:17:26.356-04,7,8,15
4628,27,2011-08-22 18:17:26.356-04,6,8,14
4629,30,2011-08-22 18:17:26.356-04,7,8,15
4630,31,2011-08-22 18:17:26.356-04,6,5,11
4631,32,2011-08-22 18:17:26.356-04,9,2,11
4632,33,2011-08-22 18:17:26.356-04,4,15,19
4633,34,2011-08-22 18:17:26.356-04,8,7,15
4634,35,2011-08-22 18:17:26.356-04,3,8,11
4635,36,2011-08-22 18:17:26.356-04,4,11,15
4636,37,2011-08-22 18:17:26.356-04,8,7,15
4637,38,2011-08-22 18:17:26.356-04,28,7,35
4638,39,2011-08-22 18:17:26.356-04,9,10,19
4639,40,2011-08-22 18:17:26.356-04,13,0,13
4640,41,2011-08-22 18:17:26.356-04,8,11,19
4641,42,2011-08-22 18:17:26.356-04,7,12,19
4642,43,2011-08-22 18:17:26.356-04,3,12,15
4643,44,2011-08-22 18:17:26.356-04,13,6,19
4644,45,2011-08-22 18:17:26.356-04,5,14,19
4645,46,2011-08-22 18:17:26.356-04,13,6,19
4646,47,2011-08-22 18:17:26.356-04,9,2,11
4647,48,2011-08-22 18:17:26.356-04,0,15,15
4648,49,2011-08-22 18:17:26.356-04,1,14,15
4649,50,2011-08-22 18:17:26.356-04,0,15,15
4650,51,2011-08-22 18:17:26.356-04,6,9,15
4651,52,2011-08-22 18:17:26.356-04,10,4,14
4652,53,2011-08-22 18:17:26.356-04,9,6,15
4653,55,2011-08-22 18:17:26.356-04,5,10,15
4654,56,2011-08-22 18:17:26.356-04,3,12,15
4655,57,2011-08-22 18:17:26.356-04,7,4,11
4656,3,2011-08-22 18:18:27.224-04,9,8,17
4657,5,2011-08-22 18:18:27.224-04,0,15,15
4658,6,2011-08-22 18:18:27.224-04,10,5,15
4659,8,2011-08-22 18:18:27.224-04,6,9,15
4660,9,2011-08-22 18:18:27.224-04,7,12,19
4661,10,2011-08-22 18:18:27.224-04,5,14,19
4662,11,2011-08-22 18:18:27.224-04,0,15,15
4663,12,2011-08-22 18:18:27.224-04,9,6,15
4664,13,2011-08-22 18:18:27.224-04,1,13,14
4665,14,2011-08-22 18:18:27.224-04,0,17,17
4666,15,2011-08-22 18:18:27.224-04,7,8,15
4667,16,2011-08-22 18:18:27.224-04,15,4,19
4668,17,2011-08-22 18:18:27.224-04,5,10,15
4669,18,2011-08-22 18:18:27.224-04,5,10,15
4670,20,2011-08-22 18:18:27.224-04,6,13,19
4671,21,2011-08-22 18:18:27.224-04,5,18,23
4672,22,2011-08-22 18:18:27.224-04,23,24,47
4673,23,2011-08-22 18:18:27.224-04,5,13,18
4674,24,2011-08-22 18:18:27.224-04,4,11,15
4675,25,2011-08-22 18:18:27.224-04,11,4,15
4676,26,2011-08-22 18:18:27.224-04,7,8,15
4677,27,2011-08-22 18:18:27.224-04,6,8,14
4678,30,2011-08-22 18:18:27.224-04,7,8,15
4679,31,2011-08-22 18:18:27.224-04,6,5,11
4680,32,2011-08-22 18:18:27.224-04,8,3,11
4681,33,2011-08-22 18:18:27.224-04,4,15,19
4682,34,2011-08-22 18:18:27.224-04,8,7,15
4683,35,2011-08-22 18:18:27.224-04,1,10,11
4684,36,2011-08-22 18:18:27.224-04,4,11,15
4685,37,2011-08-22 18:18:27.224-04,8,7,15
4686,38,2011-08-22 18:18:27.224-04,28,7,35
4687,39,2011-08-22 18:18:27.224-04,9,10,19
4688,40,2011-08-22 18:18:27.224-04,13,0,13
4689,41,2011-08-22 18:18:27.224-04,9,10,19
4690,42,2011-08-22 18:18:27.224-04,7,12,19
4691,43,2011-08-22 18:18:27.224-04,2,13,15
4692,44,2011-08-22 18:18:27.224-04,13,6,19
4693,45,2011-08-22 18:18:27.224-04,5,14,19
4694,46,2011-08-22 18:18:27.224-04,13,6,19
4695,47,2011-08-22 18:18:27.224-04,9,2,11
4696,48,2011-08-22 18:18:27.224-04,0,15,15
4697,49,2011-08-22 18:18:27.224-04,1,14,15
4698,50,2011-08-22 18:18:27.224-04,0,15,15
4699,51,2011-08-22 18:18:27.224-04,6,9,15
4700,52,2011-08-22 18:18:27.224-04,10,4,14
4701,53,2011-08-22 18:18:27.224-04,9,6,15
4702,55,2011-08-22 18:18:27.224-04,5,10,15
4703,56,2011-08-22 18:18:27.224-04,3,12,15
4704,57,2011-08-22 18:18:27.224-04,7,4,11
4705,3,2011-08-22 18:19:28.139-04,9,8,17
4706,5,2011-08-22 18:19:28.139-04,0,15,15
4707,6,2011-08-22 18:19:28.139-04,10,5,15
4708,8,2011-08-22 18:19:28.139-04,6,9,15
4709,9,2011-08-22 18:19:28.139-04,6,13,19
4710,10,2011-08-22 18:19:28.139-04,5,14,19
4711,11,2011-08-22 18:19:28.139-04,0,15,15
4712,12,2011-08-22 18:19:28.139-04,9,6,15
4713,13,2011-08-22 18:19:28.139-04,1,13,14
4714,14,2011-08-22 18:19:28.139-04,0,17,17
4715,15,2011-08-22 18:19:28.139-04,7,8,15
4716,16,2011-08-22 18:19:28.139-04,15,4,19
4717,17,2011-08-22 18:19:28.139-04,5,10,15
4718,18,2011-08-22 18:19:28.139-04,5,10,15
4719,20,2011-08-22 18:19:28.139-04,6,13,19
4720,21,2011-08-22 18:19:28.139-04,5,18,23
4721,22,2011-08-22 18:19:28.139-04,23,24,47
4722,23,2011-08-22 18:19:28.139-04,5,13,18
4723,24,2011-08-22 18:19:28.139-04,3,12,15
4724,25,2011-08-22 18:19:28.139-04,12,3,15
4725,26,2011-08-22 18:19:28.139-04,7,8,15
4726,27,2011-08-22 18:19:28.139-04,6,8,14
4727,30,2011-08-22 18:19:28.139-04,7,8,15
4728,31,2011-08-22 18:19:28.139-04,6,5,11
4729,32,2011-08-22 18:19:28.139-04,8,3,11
4730,33,2011-08-22 18:19:28.139-04,4,15,19
4731,34,2011-08-22 18:19:28.139-04,8,7,15
4732,35,2011-08-22 18:19:28.139-04,1,10,11
4733,36,2011-08-22 18:19:28.139-04,4,11,15
4734,37,2011-08-22 18:19:28.139-04,8,7,15
4735,38,2011-08-22 18:19:28.139-04,27,8,35
4736,39,2011-08-22 18:19:28.139-04,9,10,19
4737,40,2011-08-22 18:19:28.139-04,13,0,13
4738,41,2011-08-22 18:19:28.139-04,9,10,19
4739,42,2011-08-22 18:19:28.139-04,7,12,19
4740,43,2011-08-22 18:19:28.139-04,1,14,15
4741,44,2011-08-22 18:19:28.139-04,13,6,19
4742,45,2011-08-22 18:19:28.139-04,5,14,19
4743,46,2011-08-22 18:19:28.139-04,13,6,19
4744,47,2011-08-22 18:19:28.139-04,9,2,11
4745,48,2011-08-22 18:19:28.139-04,0,15,15
4746,49,2011-08-22 18:19:28.139-04,1,14,15
4747,50,2011-08-22 18:19:28.139-04,0,15,15
4748,51,2011-08-22 18:19:28.139-04,6,9,15
4749,52,2011-08-22 18:19:28.139-04,8,6,14
4750,53,2011-08-22 18:19:28.139-04,9,6,15
4751,55,2011-08-22 18:19:28.139-04,5,10,15
4752,56,2011-08-22 18:19:28.139-04,3,12,15
4753,57,2011-08-22 18:19:28.139-04,7,4,11
4754,3,2011-08-22 18:20:29.015-04,9,8,17
4755,5,2011-08-22 18:20:29.015-04,0,15,15
4756,6,2011-08-22 18:20:29.015-04,10,5,15
4757,8,2011-08-22 18:20:29.015-04,6,9,15
4758,9,2011-08-22 18:20:29.015-04,6,13,19
4759,10,2011-08-22 18:20:29.015-04,5,14,19
4760,11,2011-08-22 18:20:29.015-04,0,15,15
4761,12,2011-08-22 18:20:29.015-04,9,6,15
4762,13,2011-08-22 18:20:29.015-04,1,13,14
4763,14,2011-08-22 18:20:29.015-04,0,17,17
4764,15,2011-08-22 18:20:29.015-04,7,8,15
4765,16,2011-08-22 18:20:29.015-04,14,5,19
4766,17,2011-08-22 18:20:29.015-04,5,10,15
4767,18,2011-08-22 18:20:29.015-04,6,9,15
4768,20,2011-08-22 18:20:29.015-04,6,13,19
4769,21,2011-08-22 18:20:29.015-04,5,18,23
4770,22,2011-08-22 18:20:29.015-04,23,24,47
4771,23,2011-08-22 18:20:29.015-04,4,14,18
4772,24,2011-08-22 18:20:29.015-04,2,13,15
4773,25,2011-08-22 18:20:29.015-04,13,2,15
4774,26,2011-08-22 18:20:29.015-04,7,8,15
4775,27,2011-08-22 18:20:29.015-04,6,8,14
4776,30,2011-08-22 18:20:29.015-04,7,8,15
4777,31,2011-08-22 18:20:29.015-04,6,5,11
4778,32,2011-08-22 18:20:29.015-04,8,3,11
4779,33,2011-08-22 18:20:29.015-04,4,15,19
4780,34,2011-08-22 18:20:29.015-04,8,7,15
4781,35,2011-08-22 18:20:29.015-04,1,10,11
4782,36,2011-08-22 18:20:29.015-04,4,11,15
4783,37,2011-08-22 18:20:29.015-04,8,7,15
4784,38,2011-08-22 18:20:29.015-04,27,8,35
4785,39,2011-08-22 18:20:29.015-04,9,10,19
4786,40,2011-08-22 18:20:29.015-04,13,0,13
4787,41,2011-08-22 18:20:29.015-04,9,10,19
4788,42,2011-08-22 18:20:29.015-04,7,12,19
4789,43,2011-08-22 18:20:29.015-04,1,14,15
4790,44,2011-08-22 18:20:29.015-04,13,6,19
4791,45,2011-08-22 18:20:29.015-04,5,14,19
4792,46,2011-08-22 18:20:29.015-04,13,6,19
4793,47,2011-08-22 18:20:29.015-04,9,2,11
4794,48,2011-08-22 18:20:29.015-04,0,15,15
4795,49,2011-08-22 18:20:29.015-04,2,13,15
4796,50,2011-08-22 18:20:29.015-04,0,15,15
4797,51,2011-08-22 18:20:29.015-04,6,9,15
4798,52,2011-08-22 18:20:29.015-04,10,4,14
4799,53,2011-08-22 18:20:29.015-04,9,6,15
4800,55,2011-08-22 18:20:29.015-04,5,10,15
4801,56,2011-08-22 18:20:29.015-04,3,12,15
4802,57,2011-08-22 18:20:29.015-04,7,4,11
4803,3,2011-08-22 18:21:29.932-04,9,8,17
4804,5,2011-08-22 18:21:29.932-04,0,15,15
4805,6,2011-08-22 18:21:29.932-04,10,5,15
4806,8,2011-08-22 18:21:29.932-04,6,9,15
4807,9,2011-08-22 18:21:29.932-04,6,13,19
4808,10,2011-08-22 18:21:29.932-04,5,14,19
4809,11,2011-08-22 18:21:29.932-04,0,15,15
4810,12,2011-08-22 18:21:29.932-04,9,6,15
4811,13,2011-08-22 18:21:29.932-04,0,14,14
4812,14,2011-08-22 18:21:29.932-04,0,17,17
4813,15,2011-08-22 18:21:29.932-04,7,8,15
4814,16,2011-08-22 18:21:29.932-04,14,5,19
4815,17,2011-08-22 18:21:29.932-04,5,10,15
4816,18,2011-08-22 18:21:29.932-04,6,9,15
4817,20,2011-08-22 18:21:29.932-04,6,13,19
4818,21,2011-08-22 18:21:29.932-04,5,18,23
4819,22,2011-08-22 18:21:29.932-04,23,24,47
4820,23,2011-08-22 18:21:29.932-04,4,14,18
4821,24,2011-08-22 18:21:29.932-04,3,12,15
4822,25,2011-08-22 18:21:29.932-04,14,1,15
4823,26,2011-08-22 18:21:29.932-04,7,8,15
4824,27,2011-08-22 18:21:29.932-04,6,8,14
4825,30,2011-08-22 18:21:29.932-04,7,8,15
4826,31,2011-08-22 18:21:29.932-04,6,5,11
4827,32,2011-08-22 18:21:29.932-04,8,3,11
4828,33,2011-08-22 18:21:29.932-04,4,15,19
4829,34,2011-08-22 18:21:29.932-04,8,7,15
4830,35,2011-08-22 18:21:29.932-04,1,10,11
4831,36,2011-08-22 18:21:29.932-04,4,11,15
4832,37,2011-08-22 18:21:29.932-04,8,7,15
4833,38,2011-08-22 18:21:29.932-04,27,8,35
4834,39,2011-08-22 18:21:29.932-04,9,10,19
4835,40,2011-08-22 18:21:29.932-04,13,0,13
4836,41,2011-08-22 18:21:29.932-04,9,10,19
4837,42,2011-08-22 18:21:29.932-04,7,12,19
4838,43,2011-08-22 18:21:29.932-04,1,14,15
4839,44,2011-08-22 18:21:29.932-04,13,6,19
4840,45,2011-08-22 18:21:29.932-04,5,14,19
4841,46,2011-08-22 18:21:29.932-04,13,6,19
4842,47,2011-08-22 18:21:29.932-04,9,2,11
4843,48,2011-08-22 18:21:29.932-04,0,15,15
4844,49,2011-08-22 18:21:29.932-04,2,13,15
4845,50,2011-08-22 18:21:29.932-04,0,15,15
4846,51,2011-08-22 18:21:29.932-04,6,9,15
4847,52,2011-08-22 18:21:29.932-04,11,3,14
4848,53,2011-08-22 18:21:29.932-04,9,6,15
4849,55,2011-08-22 18:21:29.932-04,3,12,15
4850,56,2011-08-22 18:21:29.932-04,3,12,15
4851,57,2011-08-22 18:21:29.932-04,7,4,11
4852,3,2011-08-22 18:22:30.884-04,9,8,17
4853,5,2011-08-22 18:22:30.884-04,0,15,15
4854,6,2011-08-22 18:22:30.884-04,10,5,15
4855,8,2011-08-22 18:22:30.884-04,6,9,15
4856,9,2011-08-22 18:22:30.884-04,6,13,19
4857,10,2011-08-22 18:22:30.884-04,5,14,19
4858,11,2011-08-22 18:22:30.884-04,0,15,15
4859,12,2011-08-22 18:22:30.884-04,9,6,15
4860,13,2011-08-22 18:22:30.884-04,0,14,14
4861,14,2011-08-22 18:22:30.884-04,0,17,17
4862,15,2011-08-22 18:22:30.884-04,7,8,15
4863,16,2011-08-22 18:22:30.884-04,14,5,19
4864,17,2011-08-22 18:22:30.884-04,5,10,15
4865,18,2011-08-22 18:22:30.884-04,6,9,15
4866,20,2011-08-22 18:22:30.884-04,6,13,19
4867,21,2011-08-22 18:22:30.884-04,5,18,23
4868,22,2011-08-22 18:22:30.884-04,22,25,47
4869,23,2011-08-22 18:22:30.884-04,4,14,18
4870,24,2011-08-22 18:22:30.884-04,3,12,15
4871,25,2011-08-22 18:22:30.884-04,14,1,15
4872,26,2011-08-22 18:22:30.884-04,7,8,15
4873,27,2011-08-22 18:22:30.884-04,6,8,14
4874,30,2011-08-22 18:22:30.884-04,7,8,15
4875,31,2011-08-22 18:22:30.884-04,6,5,11
4876,32,2011-08-22 18:22:30.884-04,9,2,11
4877,33,2011-08-22 18:22:30.884-04,4,15,19
4878,34,2011-08-22 18:22:30.884-04,8,7,15
4879,35,2011-08-22 18:22:30.884-04,1,10,11
4880,36,2011-08-22 18:22:30.884-04,4,11,15
4881,37,2011-08-22 18:22:30.884-04,8,7,15
4882,38,2011-08-22 18:22:30.884-04,27,8,35
4883,39,2011-08-22 18:22:30.884-04,9,10,19
4884,40,2011-08-22 18:22:30.884-04,13,0,13
4885,41,2011-08-22 18:22:30.884-04,9,10,19
4886,42,2011-08-22 18:22:30.884-04,7,12,19
4887,43,2011-08-22 18:22:30.884-04,5,10,15
4888,44,2011-08-22 18:22:30.884-04,13,6,19
4889,45,2011-08-22 18:22:30.884-04,5,14,19
4890,46,2011-08-22 18:22:30.884-04,13,6,19
4891,47,2011-08-22 18:22:30.884-04,9,2,11
4892,48,2011-08-22 18:22:30.884-04,0,15,15
4893,49,2011-08-22 18:22:30.884-04,2,13,15
4894,50,2011-08-22 18:22:30.884-04,0,15,15
4895,51,2011-08-22 18:22:30.884-04,6,9,15
4896,52,2011-08-22 18:22:30.884-04,11,3,14
4897,53,2011-08-22 18:22:30.884-04,9,6,15
4898,55,2011-08-22 18:22:30.884-04,2,13,15
4899,56,2011-08-22 18:22:30.884-04,4,11,15
4900,57,2011-08-22 18:22:30.884-04,7,4,11
4901,3,2011-08-22 18:23:31.76-04,9,8,17
4902,5,2011-08-22 18:23:31.76-04,0,15,15
4903,6,2011-08-22 18:23:31.76-04,10,5,15
4904,8,2011-08-22 18:23:31.76-04,6,9,15
4905,9,2011-08-22 18:23:31.76-04,6,13,19
4906,10,2011-08-22 18:23:31.76-04,5,14,19
4907,11,2011-08-22 18:23:31.76-04,0,15,15
4908,12,2011-08-22 18:23:31.76-04,9,6,15
4909,13,2011-08-22 18:23:31.76-04,0,14,14
4910,14,2011-08-22 18:23:31.76-04,0,17,17
4911,15,2011-08-22 18:23:31.76-04,7,8,15
4912,16,2011-08-22 18:23:31.76-04,14,5,19
4913,17,2011-08-22 18:23:31.76-04,5,10,15
4914,18,2011-08-22 18:23:31.76-04,6,9,15
4915,20,2011-08-22 18:23:31.76-04,6,13,19
4916,21,2011-08-22 18:23:31.76-04,5,18,23
4917,22,2011-08-22 18:23:31.76-04,22,25,47
4918,23,2011-08-22 18:23:31.76-04,4,14,18
4919,24,2011-08-22 18:23:31.76-04,3,12,15
4920,25,2011-08-22 18:23:31.76-04,14,1,15
4921,26,2011-08-22 18:23:31.76-04,7,8,15
4922,27,2011-08-22 18:23:31.76-04,6,8,14
4923,30,2011-08-22 18:23:31.76-04,8,7,15
4924,31,2011-08-22 18:23:31.76-04,6,5,11
4925,32,2011-08-22 18:23:31.76-04,8,3,11
4926,33,2011-08-22 18:23:31.76-04,4,15,19
4927,34,2011-08-22 18:23:31.76-04,8,7,15
4928,35,2011-08-22 18:23:31.76-04,1,10,11
4929,36,2011-08-22 18:23:31.76-04,3,12,15
4930,37,2011-08-22 18:23:31.76-04,8,7,15
4931,38,2011-08-22 18:23:31.76-04,27,8,35
4932,39,2011-08-22 18:23:31.76-04,9,10,19
4933,40,2011-08-22 18:23:31.76-04,13,0,13
4934,41,2011-08-22 18:23:31.76-04,9,10,19
4935,42,2011-08-22 18:23:31.76-04,7,12,19
4936,43,2011-08-22 18:23:31.76-04,5,10,15
4937,44,2011-08-22 18:23:31.76-04,13,6,19
4938,45,2011-08-22 18:23:31.76-04,5,14,19
4939,46,2011-08-22 18:23:31.76-04,13,6,19
4940,47,2011-08-22 18:23:31.76-04,9,2,11
4941,48,2011-08-22 18:23:31.76-04,3,12,15
4942,49,2011-08-22 18:23:31.76-04,3,12,15
4943,50,2011-08-22 18:23:31.76-04,0,15,15
4944,51,2011-08-22 18:23:31.76-04,6,9,15
4945,52,2011-08-22 18:23:31.76-04,11,3,14
4946,53,2011-08-22 18:23:31.76-04,9,6,15
4947,55,2011-08-22 18:23:31.76-04,2,13,15
4948,56,2011-08-22 18:23:31.76-04,4,11,15
4949,57,2011-08-22 18:23:31.76-04,7,4,11
4950,3,2011-08-22 18:24:32.719-04,9,8,17
4951,5,2011-08-22 18:24:32.719-04,0,15,15
4952,6,2011-08-22 18:24:32.719-04,10,5,15
4953,8,2011-08-22 18:24:32.719-04,6,9,15
4954,9,2011-08-22 18:24:32.719-04,6,13,19
4955,10,2011-08-22 18:24:32.719-04,5,14,19
4956,11,2011-08-22 18:24:32.719-04,0,15,15
4957,12,2011-08-22 18:24:32.719-04,9,6,15
4958,13,2011-08-22 18:24:32.719-04,0,14,14
4959,14,2011-08-22 18:24:32.719-04,0,17,17
4960,15,2011-08-22 18:24:32.719-04,7,8,15
4961,16,2011-08-22 18:24:32.719-04,14,5,19
4962,17,2011-08-22 18:24:32.719-04,5,10,15
4963,18,2011-08-22 18:24:32.719-04,6,9,15
4964,20,2011-08-22 18:24:32.719-04,7,12,19
4965,21,2011-08-22 18:24:32.719-04,5,18,23
4966,22,2011-08-22 18:24:32.719-04,23,24,47
4967,23,2011-08-22 18:24:32.719-04,4,14,18
4968,24,2011-08-22 18:24:32.719-04,3,12,15
4969,25,2011-08-22 18:24:32.719-04,14,1,15
4970,26,2011-08-22 18:24:32.719-04,7,8,15
4971,27,2011-08-22 18:24:32.719-04,6,8,14
4972,30,2011-08-22 18:24:32.719-04,8,7,15
4973,31,2011-08-22 18:24:32.719-04,6,5,11
4974,32,2011-08-22 18:24:32.719-04,8,3,11
4975,33,2011-08-22 18:24:32.719-04,4,15,19
4976,34,2011-08-22 18:24:32.719-04,8,7,15
4977,35,2011-08-22 18:24:32.719-04,1,10,11
4978,36,2011-08-22 18:24:32.719-04,3,12,15
4979,37,2011-08-22 18:24:32.719-04,8,7,15
4980,38,2011-08-22 18:24:32.719-04,27,8,35
4981,39,2011-08-22 18:24:32.719-04,9,10,19
4982,40,2011-08-22 18:24:32.719-04,13,0,13
4983,41,2011-08-22 18:24:32.719-04,9,10,19
4984,42,2011-08-22 18:24:32.719-04,7,12,19
4985,43,2011-08-22 18:24:32.719-04,5,10,15
4986,44,2011-08-22 18:24:32.719-04,13,6,19
4987,45,2011-08-22 18:24:32.719-04,5,14,19
4988,46,2011-08-22 18:24:32.719-04,13,6,19
4989,47,2011-08-22 18:24:32.719-04,9,2,11
4990,48,2011-08-22 18:24:32.719-04,3,12,15
4991,49,2011-08-22 18:24:32.719-04,6,9,15
4992,50,2011-08-22 18:24:32.719-04,0,15,15
4993,51,2011-08-22 18:24:32.719-04,6,9,15
4994,52,2011-08-22 18:24:32.719-04,9,5,14
4995,53,2011-08-22 18:24:32.719-04,10,5,15
4996,55,2011-08-22 18:24:32.719-04,2,13,15
4997,56,2011-08-22 18:24:32.719-04,4,11,15
4998,57,2011-08-22 18:24:32.719-04,7,4,11
4999,3,2011-08-22 18:25:33.835-04,9,8,17
5000,5,2011-08-22 18:25:33.835-04,0,15,15
5001,6,2011-08-22 18:25:33.835-04,11,4,15
5002,8,2011-08-22 18:25:33.835-04,6,9,15
5003,9,2011-08-22 18:25:33.835-04,6,13,19
5004,10,2011-08-22 18:25:33.835-04,5,14,19
5005,11,2011-08-22 18:25:33.835-04,0,15,15
5006,12,2011-08-22 18:25:33.835-04,9,6,15
5007,13,2011-08-22 18:25:33.835-04,0,14,14
5008,14,2011-08-22 18:25:33.835-04,0,17,17
5009,15,2011-08-22 18:25:33.835-04,7,8,15
5010,16,2011-08-22 18:25:33.835-04,14,5,19
5011,17,2011-08-22 18:25:33.835-04,5,10,15
5012,18,2011-08-22 18:25:33.835-04,6,9,15
5013,20,2011-08-22 18:25:33.835-04,7,12,19
5014,21,2011-08-22 18:25:33.835-04,5,18,23
5015,22,2011-08-22 18:25:33.835-04,22,25,47
5016,23,2011-08-22 18:25:33.835-04,4,14,18
5017,24,2011-08-22 18:25:33.835-04,3,12,15
5018,25,2011-08-22 18:25:33.835-04,13,2,15
5019,26,2011-08-22 18:25:33.835-04,7,8,15
5020,27,2011-08-22 18:25:33.835-04,6,8,14
5021,30,2011-08-22 18:25:33.835-04,8,7,15
5022,31,2011-08-22 18:25:33.835-04,5,6,11
5023,32,2011-08-22 18:25:33.835-04,8,3,11
5024,33,2011-08-22 18:25:33.835-04,4,15,19
5025,34,2011-08-22 18:25:33.835-04,8,7,15
5026,35,2011-08-22 18:25:33.835-04,1,10,11
5027,36,2011-08-22 18:25:33.835-04,3,12,15
5028,37,2011-08-22 18:25:33.835-04,8,7,15
5029,38,2011-08-22 18:25:33.835-04,27,8,35
5030,39,2011-08-22 18:25:33.835-04,9,10,19
5031,40,2011-08-22 18:25:33.835-04,13,0,13
5032,41,2011-08-22 18:25:33.835-04,9,10,19
5033,42,2011-08-22 18:25:33.835-04,7,12,19
5034,43,2011-08-22 18:25:33.835-04,5,10,15
5035,44,2011-08-22 18:25:33.835-04,13,6,19
5036,45,2011-08-22 18:25:33.835-04,5,14,19
5037,46,2011-08-22 18:25:33.835-04,13,6,19
5038,47,2011-08-22 18:25:33.835-04,10,1,11
5039,48,2011-08-22 18:25:33.835-04,3,12,15
5040,49,2011-08-22 18:25:33.835-04,7,8,15
5041,50,2011-08-22 18:25:33.835-04,0,15,15
5042,51,2011-08-22 18:25:33.835-04,6,9,15
5043,52,2011-08-22 18:25:33.835-04,8,6,14
5044,53,2011-08-22 18:25:33.835-04,10,5,15
5045,55,2011-08-22 18:25:33.835-04,2,13,15
5046,56,2011-08-22 18:25:33.835-04,4,11,15
5047,57,2011-08-22 18:25:33.835-04,7,4,11
5048,3,2011-08-22 18:26:34.837-04,9,8,17
5049,5,2011-08-22 18:26:34.837-04,0,15,15
5050,6,2011-08-22 18:26:34.837-04,11,4,15
5051,8,2011-08-22 18:26:34.837-04,6,9,15
5052,9,2011-08-22 18:26:34.837-04,6,13,19
5053,10,2011-08-22 18:26:34.837-04,5,14,19
5054,11,2011-08-22 18:26:34.837-04,0,15,15
5055,12,2011-08-22 18:26:34.837-04,9,6,15
5056,13,2011-08-22 18:26:34.837-04,0,14,14
5057,14,2011-08-22 18:26:34.837-04,0,17,17
5058,15,2011-08-22 18:26:34.837-04,7,8,15
5059,16,2011-08-22 18:26:34.837-04,14,5,19
5060,17,2011-08-22 18:26:34.837-04,5,10,15
5061,18,2011-08-22 18:26:34.837-04,6,9,15
5062,20,2011-08-22 18:26:34.837-04,7,12,19
5063,21,2011-08-22 18:26:34.837-04,5,18,23
5064,22,2011-08-22 18:26:34.837-04,21,26,47
5065,23,2011-08-22 18:26:34.837-04,4,14,18
5066,24,2011-08-22 18:26:34.837-04,3,12,15
5067,25,2011-08-22 18:26:34.837-04,13,2,15
5068,26,2011-08-22 18:26:34.837-04,7,8,15
5069,27,2011-08-22 18:26:34.837-04,7,7,14
5070,30,2011-08-22 18:26:34.837-04,8,7,15
5071,31,2011-08-22 18:26:34.837-04,5,6,11
5072,32,2011-08-22 18:26:34.837-04,8,3,11
5073,33,2011-08-22 18:26:34.837-04,4,15,19
5074,34,2011-08-22 18:26:34.837-04,8,7,15
5075,35,2011-08-22 18:26:34.837-04,1,10,11
5076,36,2011-08-22 18:26:34.837-04,3,12,15
5077,37,2011-08-22 18:26:34.837-04,8,7,15
5078,38,2011-08-22 18:26:34.837-04,27,8,35
5079,39,2011-08-22 18:26:34.837-04,9,10,19
5080,40,2011-08-22 18:26:34.837-04,13,0,13
5081,41,2011-08-22 18:26:34.837-04,9,10,19
5082,42,2011-08-22 18:26:34.837-04,6,13,19
5083,43,2011-08-22 18:26:34.837-04,4,11,15
5084,44,2011-08-22 18:26:34.837-04,13,6,19
5085,45,2011-08-22 18:26:34.837-04,5,14,19
5086,46,2011-08-22 18:26:34.837-04,13,6,19
5087,47,2011-08-22 18:26:34.837-04,10,1,11
5088,48,2011-08-22 18:26:34.837-04,3,12,15
5089,49,2011-08-22 18:26:34.837-04,8,7,15
5090,50,2011-08-22 18:26:34.837-04,0,15,15
5091,51,2011-08-22 18:26:34.837-04,6,9,15
5092,52,2011-08-22 18:26:34.837-04,8,6,14
5093,53,2011-08-22 18:26:34.837-04,10,5,15
5094,55,2011-08-22 18:26:34.837-04,2,13,15
5095,56,2011-08-22 18:26:34.837-04,4,11,15
5096,57,2011-08-22 18:26:34.837-04,7,4,11
5097,3,2011-08-22 18:27:35.755-04,9,8,17
5098,5,2011-08-22 18:27:35.755-04,0,15,15
5099,6,2011-08-22 18:27:35.755-04,11,4,15
5100,8,2011-08-22 18:27:35.755-04,6,9,15
5101,9,2011-08-22 18:27:35.755-04,6,13,19
5102,10,2011-08-22 18:27:35.755-04,5,14,19
5103,11,2011-08-22 18:27:35.755-04,0,15,15
5104,12,2011-08-22 18:27:35.755-04,9,6,15
5105,13,2011-08-22 18:27:35.755-04,0,14,14
5106,14,2011-08-22 18:27:35.755-04,0,17,17
5107,15,2011-08-22 18:27:35.755-04,7,8,15
5108,16,2011-08-22 18:27:35.755-04,14,5,19
5109,17,2011-08-22 18:27:35.755-04,5,10,15
5110,18,2011-08-22 18:27:35.755-04,6,9,15
5111,20,2011-08-22 18:27:35.755-04,7,12,19
5112,21,2011-08-22 18:27:35.755-04,5,18,23
5113,22,2011-08-22 18:27:35.755-04,21,26,47
5114,23,2011-08-22 18:27:35.755-04,4,14,18
5115,24,2011-08-22 18:27:35.755-04,3,12,15
5116,25,2011-08-22 18:27:35.755-04,13,2,15
5117,26,2011-08-22 18:27:35.755-04,7,8,15
5118,27,2011-08-22 18:27:35.755-04,7,7,14
5119,30,2011-08-22 18:27:35.755-04,8,7,15
5120,31,2011-08-22 18:27:35.755-04,5,6,11
5121,32,2011-08-22 18:27:35.755-04,8,3,11
5122,33,2011-08-22 18:27:35.755-04,4,15,19
5123,34,2011-08-22 18:27:35.755-04,8,7,15
5124,35,2011-08-22 18:27:35.755-04,1,10,11
5125,36,2011-08-22 18:27:35.755-04,3,12,15
5126,37,2011-08-22 18:27:35.755-04,8,7,15
5127,38,2011-08-22 18:27:35.755-04,26,9,35
5128,39,2011-08-22 18:27:35.755-04,9,10,19
5129,40,2011-08-22 18:27:35.755-04,11,2,13
5130,41,2011-08-22 18:27:35.755-04,9,10,19
5131,42,2011-08-22 18:27:35.755-04,6,13,19
5132,43,2011-08-22 18:27:35.755-04,4,11,15
5133,44,2011-08-22 18:27:35.755-04,13,6,19
5134,45,2011-08-22 18:27:35.755-04,5,14,19
5135,46,2011-08-22 18:27:35.755-04,13,6,19
5136,47,2011-08-22 18:27:35.755-04,10,1,11
5137,48,2011-08-22 18:27:35.755-04,3,12,15
5138,49,2011-08-22 18:27:35.755-04,8,7,15
5139,50,2011-08-22 18:27:35.755-04,0,15,15
5140,51,2011-08-22 18:27:35.755-04,6,9,15
5141,52,2011-08-22 18:27:35.755-04,7,7,14
5142,53,2011-08-22 18:27:35.755-04,10,5,15
5143,55,2011-08-22 18:27:35.755-04,2,13,15
5144,56,2011-08-22 18:27:35.755-04,4,11,15
5145,57,2011-08-22 18:27:35.755-04,7,4,11
5146,3,2011-08-22 18:28:36.592-04,9,8,17
5147,5,2011-08-22 18:28:36.592-04,0,15,15
5148,6,2011-08-22 18:28:36.592-04,11,4,15
5149,8,2011-08-22 18:28:36.592-04,6,9,15
5150,9,2011-08-22 18:28:36.592-04,6,13,19
5151,10,2011-08-22 18:28:36.592-04,5,14,19
5152,11,2011-08-22 18:28:36.592-04,0,15,15
5153,12,2011-08-22 18:28:36.592-04,9,6,15
5154,13,2011-08-22 18:28:36.592-04,0,14,14
5155,14,2011-08-22 18:28:36.592-04,0,17,17
5156,15,2011-08-22 18:28:36.592-04,8,7,15
5157,16,2011-08-22 18:28:36.592-04,14,5,19
5158,17,2011-08-22 18:28:36.592-04,5,10,15
5159,18,2011-08-22 18:28:36.592-04,6,9,15
5160,20,2011-08-22 18:28:36.592-04,7,12,19
5161,21,2011-08-22 18:28:36.592-04,5,18,23
5162,22,2011-08-22 18:28:36.592-04,23,24,47
5163,23,2011-08-22 18:28:36.592-04,4,14,18
5164,24,2011-08-22 18:28:36.592-04,2,13,15
5165,25,2011-08-22 18:28:36.592-04,13,2,15
5166,26,2011-08-22 18:28:36.592-04,7,8,15
5167,27,2011-08-22 18:28:36.592-04,7,7,14
5168,30,2011-08-22 18:28:36.592-04,8,7,15
5169,31,2011-08-22 18:28:36.592-04,5,6,11
5170,32,2011-08-22 18:28:36.592-04,8,3,11
5171,33,2011-08-22 18:28:36.592-04,4,15,19
5172,34,2011-08-22 18:28:36.592-04,8,7,15
5173,35,2011-08-22 18:28:36.592-04,1,10,11
5174,36,2011-08-22 18:28:36.592-04,4,11,15
5175,37,2011-08-22 18:28:36.592-04,8,7,15
5176,38,2011-08-22 18:28:36.592-04,26,9,35
5177,39,2011-08-22 18:28:36.592-04,9,10,19
5178,40,2011-08-22 18:28:36.592-04,11,2,13
5179,41,2011-08-22 18:28:36.592-04,9,10,19
5180,42,2011-08-22 18:28:36.592-04,6,13,19
5181,43,2011-08-22 18:28:36.592-04,3,12,15
5182,44,2011-08-22 18:28:36.592-04,14,5,19
5183,45,2011-08-22 18:28:36.592-04,5,14,19
5184,46,2011-08-22 18:28:36.592-04,13,6,19
5185,47,2011-08-22 18:28:36.592-04,10,1,11
5186,48,2011-08-22 18:28:36.592-04,3,12,15
5187,49,2011-08-22 18:28:36.592-04,8,7,15
5188,50,2011-08-22 18:28:36.592-04,0,15,15
5189,51,2011-08-22 18:28:36.592-04,6,9,15
5190,52,2011-08-22 18:28:36.592-04,7,7,14
5191,53,2011-08-22 18:28:36.592-04,10,5,15
5192,55,2011-08-22 18:28:36.592-04,2,13,15
5193,56,2011-08-22 18:28:36.592-04,4,11,15
5194,57,2011-08-22 18:28:36.592-04,7,4,11
5195,3,2011-08-22 18:29:37.467-04,9,8,17
5196,5,2011-08-22 18:29:37.467-04,0,15,15
5197,6,2011-08-22 18:29:37.467-04,11,4,15
5198,8,2011-08-22 18:29:37.467-04,6,9,15
5199,9,2011-08-22 18:29:37.467-04,6,13,19
5200,10,2011-08-22 18:29:37.467-04,5,14,19
5201,11,2011-08-22 18:29:37.467-04,0,15,15
5202,12,2011-08-22 18:29:37.467-04,9,6,15
5203,13,2011-08-22 18:29:37.467-04,0,14,14
5204,14,2011-08-22 18:29:37.467-04,0,17,17
5205,15,2011-08-22 18:29:37.467-04,8,7,15
5206,16,2011-08-22 18:29:37.467-04,14,5,19
5207,17,2011-08-22 18:29:37.467-04,5,10,15
5208,18,2011-08-22 18:29:37.467-04,6,9,15
5209,20,2011-08-22 18:29:37.467-04,7,12,19
5210,21,2011-08-22 18:29:37.467-04,5,18,23
5211,22,2011-08-22 18:29:37.467-04,23,24,47
5212,23,2011-08-22 18:29:37.467-04,4,14,18
5213,24,2011-08-22 18:29:37.467-04,2,13,15
5214,25,2011-08-22 18:29:37.467-04,13,2,15
5215,26,2011-08-22 18:29:37.467-04,7,8,15
5216,27,2011-08-22 18:29:37.467-04,7,7,14
5217,30,2011-08-22 18:29:37.467-04,8,7,15
5218,31,2011-08-22 18:29:37.467-04,5,6,11
5219,32,2011-08-22 18:29:37.467-04,8,3,11
5220,33,2011-08-22 18:29:37.467-04,4,15,19
5221,34,2011-08-22 18:29:37.467-04,8,7,15
5222,35,2011-08-22 18:29:37.467-04,1,10,11
5223,36,2011-08-22 18:29:37.467-04,6,9,15
5224,37,2011-08-22 18:29:37.467-04,8,7,15
5225,38,2011-08-22 18:29:37.467-04,26,9,35
5226,39,2011-08-22 18:29:37.467-04,9,10,19
5227,40,2011-08-22 18:29:37.467-04,11,2,13
5228,41,2011-08-22 18:29:37.467-04,11,8,19
5229,42,2011-08-22 18:29:37.467-04,6,13,19
5230,43,2011-08-22 18:29:37.467-04,3,12,15
5231,44,2011-08-22 18:29:37.467-04,14,5,19
5232,45,2011-08-22 18:29:37.467-04,5,14,19
5233,46,2011-08-22 18:29:37.467-04,13,6,19
5234,47,2011-08-22 18:29:37.467-04,11,0,11
5235,48,2011-08-22 18:29:37.467-04,3,12,15
5236,49,2011-08-22 18:29:37.467-04,8,7,15
5237,50,2011-08-22 18:29:37.467-04,0,15,15
5238,51,2011-08-22 18:29:37.467-04,6,9,15
5239,52,2011-08-22 18:29:37.467-04,7,7,14
5240,53,2011-08-22 18:29:37.467-04,10,5,15
5241,55,2011-08-22 18:29:37.467-04,2,13,15
5242,56,2011-08-22 18:29:37.467-04,4,11,15
5243,57,2011-08-22 18:29:37.467-04,7,4,11
5244,3,2011-08-22 18:30:38.332-04,9,8,17
5245,5,2011-08-22 18:30:38.332-04,0,15,15
5246,6,2011-08-22 18:30:38.332-04,11,4,15
5247,8,2011-08-22 18:30:38.332-04,6,9,15
5248,9,2011-08-22 18:30:38.332-04,6,13,19
5249,10,2011-08-22 18:30:38.332-04,5,14,19
5250,11,2011-08-22 18:30:38.332-04,0,15,15
5251,12,2011-08-22 18:30:38.332-04,9,6,15
5252,13,2011-08-22 18:30:38.332-04,0,14,14
5253,14,2011-08-22 18:30:38.332-04,0,17,17
5254,15,2011-08-22 18:30:38.332-04,8,7,15
5255,16,2011-08-22 18:30:38.332-04,14,5,19
5256,17,2011-08-22 18:30:38.332-04,5,10,15
5257,18,2011-08-22 18:30:38.332-04,6,9,15
5258,20,2011-08-22 18:30:38.332-04,7,12,19
5259,21,2011-08-22 18:30:38.332-04,5,18,23
5260,22,2011-08-22 18:30:38.332-04,24,23,47
5261,23,2011-08-22 18:30:38.332-04,4,14,18
5262,24,2011-08-22 18:30:38.332-04,3,12,15
5263,25,2011-08-22 18:30:38.332-04,12,3,15
5264,26,2011-08-22 18:30:38.332-04,7,8,15
5265,27,2011-08-22 18:30:38.332-04,7,7,14
5266,30,2011-08-22 18:30:38.332-04,8,7,15
5267,31,2011-08-22 18:30:38.332-04,5,6,11
5268,32,2011-08-22 18:30:38.332-04,8,3,11
5269,33,2011-08-22 18:30:38.332-04,4,15,19
5270,34,2011-08-22 18:30:38.332-04,8,7,15
5271,35,2011-08-22 18:30:38.332-04,1,10,11
5272,36,2011-08-22 18:30:38.332-04,7,8,15
5273,37,2011-08-22 18:30:38.332-04,8,7,15
5274,38,2011-08-22 18:30:38.332-04,26,9,35
5275,39,2011-08-22 18:30:38.332-04,8,11,19
5276,40,2011-08-22 18:30:38.332-04,9,4,13
5277,41,2011-08-22 18:30:38.332-04,12,7,19
5278,42,2011-08-22 18:30:38.332-04,6,13,19
5279,43,2011-08-22 18:30:38.332-04,3,12,15
5280,44,2011-08-22 18:30:38.332-04,14,5,19
5281,45,2011-08-22 18:30:38.332-04,5,14,19
5282,46,2011-08-22 18:30:38.332-04,13,6,19
5283,47,2011-08-22 18:30:38.332-04,11,0,11
5284,48,2011-08-22 18:30:38.332-04,3,12,15
5285,49,2011-08-22 18:30:38.332-04,8,7,15
5286,50,2011-08-22 18:30:38.332-04,0,15,15
5287,51,2011-08-22 18:30:38.332-04,6,9,15
5288,52,2011-08-22 18:30:38.332-04,7,7,14
5289,53,2011-08-22 18:30:38.332-04,11,4,15
5290,55,2011-08-22 18:30:38.332-04,4,11,15
5291,56,2011-08-22 18:30:38.332-04,4,11,15
5292,57,2011-08-22 18:30:38.332-04,7,4,11
5293,3,2011-08-22 18:31:43.026-04,9,8,17
5294,5,2011-08-22 18:31:43.026-04,0,15,15
5295,6,2011-08-22 18:31:43.026-04,11,4,15
5296,8,2011-08-22 18:31:43.026-04,6,9,15
5297,9,2011-08-22 18:31:43.026-04,6,13,19
5298,10,2011-08-22 18:31:43.026-04,5,14,19
5299,11,2011-08-22 18:31:43.026-04,0,15,15
5300,12,2011-08-22 18:31:43.026-04,9,6,15
5301,13,2011-08-22 18:31:43.026-04,0,14,14
5302,14,2011-08-22 18:31:43.026-04,0,17,17
5303,15,2011-08-22 18:31:43.026-04,8,7,15
5304,16,2011-08-22 18:31:43.026-04,13,6,19
5305,17,2011-08-22 18:31:43.026-04,5,10,15
5306,18,2011-08-22 18:31:43.026-04,6,9,15
5307,20,2011-08-22 18:31:43.026-04,7,12,19
5308,21,2011-08-22 18:31:43.026-04,5,18,23
5309,22,2011-08-22 18:31:43.026-04,25,22,47
5310,23,2011-08-22 18:31:43.026-04,4,14,18
5311,24,2011-08-22 18:31:43.026-04,3,12,15
5312,25,2011-08-22 18:31:43.026-04,12,3,15
5313,26,2011-08-22 18:31:43.026-04,7,8,15
5314,27,2011-08-22 18:31:43.026-04,7,7,14
5315,30,2011-08-22 18:31:43.026-04,10,5,15
5316,31,2011-08-22 18:31:43.026-04,4,7,11
5317,32,2011-08-22 18:31:43.026-04,8,3,11
5318,33,2011-08-22 18:31:43.026-04,4,15,19
5319,34,2011-08-22 18:31:43.026-04,8,7,15
5320,35,2011-08-22 18:31:43.026-04,1,10,11
5321,36,2011-08-22 18:31:43.026-04,7,8,15
5322,37,2011-08-22 18:31:43.026-04,8,7,15
5323,38,2011-08-22 18:31:43.026-04,26,9,35
5324,39,2011-08-22 18:31:43.026-04,8,11,19
5325,40,2011-08-22 18:31:43.026-04,11,2,13
5326,41,2011-08-22 18:31:43.026-04,12,7,19
5327,42,2011-08-22 18:31:43.026-04,6,13,19
5328,43,2011-08-22 18:31:43.026-04,3,12,15
5329,44,2011-08-22 18:31:43.026-04,14,5,19
5330,45,2011-08-22 18:31:43.026-04,5,14,19
5331,46,2011-08-22 18:31:43.026-04,13,6,19
5332,47,2011-08-22 18:31:43.026-04,11,0,11
5333,48,2011-08-22 18:31:43.026-04,3,12,15
5334,49,2011-08-22 18:31:43.026-04,8,7,15
5335,50,2011-08-22 18:31:43.026-04,0,15,15
5336,51,2011-08-22 18:31:43.026-04,6,9,15
5337,52,2011-08-22 18:31:43.026-04,7,7,14
5338,53,2011-08-22 18:31:43.026-04,11,4,15
5339,55,2011-08-22 18:31:43.026-04,4,11,15
5340,56,2011-08-22 18:31:43.026-04,4,11,15
5341,57,2011-08-22 18:31:43.026-04,7,4,11
5342,3,2011-08-22 18:32:44.036-04,9,8,17
5343,5,2011-08-22 18:32:44.036-04,0,15,15
5344,6,2011-08-22 18:32:44.036-04,11,4,15
5345,8,2011-08-22 18:32:44.036-04,6,9,15
5346,9,2011-08-22 18:32:44.036-04,6,13,19
5347,10,2011-08-22 18:32:44.036-04,5,14,19
5348,11,2011-08-22 18:32:44.036-04,0,15,15
5349,12,2011-08-22 18:32:44.036-04,10,5,15
5350,13,2011-08-22 18:32:44.036-04,0,14,14
5351,14,2011-08-22 18:32:44.036-04,0,17,17
5352,15,2011-08-22 18:32:44.036-04,8,7,15
5353,16,2011-08-22 18:32:44.036-04,13,6,19
5354,17,2011-08-22 18:32:44.036-04,5,10,15
5355,18,2011-08-22 18:32:44.036-04,6,9,15
5356,20,2011-08-22 18:32:44.036-04,7,12,19
5357,21,2011-08-22 18:32:44.036-04,5,18,23
5358,22,2011-08-22 18:32:44.036-04,24,23,47
5359,23,2011-08-22 18:32:44.036-04,4,14,18
5360,24,2011-08-22 18:32:44.036-04,3,12,15
5361,25,2011-08-22 18:32:44.036-04,12,3,15
5362,26,2011-08-22 18:32:44.036-04,7,8,15
5363,27,2011-08-22 18:32:44.036-04,7,7,14
5364,30,2011-08-22 18:32:44.036-04,10,5,15
5365,31,2011-08-22 18:32:44.036-04,4,7,11
5366,32,2011-08-22 18:32:44.036-04,8,3,11
5367,33,2011-08-22 18:32:44.036-04,4,15,19
5368,34,2011-08-22 18:32:44.036-04,8,7,15
5369,35,2011-08-22 18:32:44.036-04,1,10,11
5370,36,2011-08-22 18:32:44.036-04,6,9,15
5371,37,2011-08-22 18:32:44.036-04,8,7,15
5372,38,2011-08-22 18:32:44.036-04,26,9,35
5373,39,2011-08-22 18:32:44.036-04,8,11,19
5374,40,2011-08-22 18:32:44.036-04,10,3,13
5375,41,2011-08-22 18:32:44.036-04,12,7,19
5376,42,2011-08-22 18:32:44.036-04,6,13,19
5377,43,2011-08-22 18:32:44.036-04,3,12,15
5378,44,2011-08-22 18:32:44.036-04,14,5,19
5379,45,2011-08-22 18:32:44.036-04,5,14,19
5380,46,2011-08-22 18:32:44.036-04,13,6,19
5381,47,2011-08-22 18:32:44.036-04,11,0,11
5382,48,2011-08-22 18:32:44.036-04,3,12,15
5383,49,2011-08-22 18:32:44.036-04,8,7,15
5384,50,2011-08-22 18:32:44.036-04,0,15,15
5385,51,2011-08-22 18:32:44.036-04,6,9,15
5386,52,2011-08-22 18:32:44.036-04,7,7,14
5387,53,2011-08-22 18:32:44.036-04,10,5,15
5388,55,2011-08-22 18:32:44.036-04,4,11,15
5389,56,2011-08-22 18:32:44.036-04,4,11,15
5390,57,2011-08-22 18:32:44.036-04,7,4,11
5391,3,2011-08-22 18:33:45.121-04,9,8,17
5392,5,2011-08-22 18:33:45.121-04,0,15,15
5393,6,2011-08-22 18:33:45.121-04,11,4,15
5394,8,2011-08-22 18:33:45.121-04,6,9,15
5395,9,2011-08-22 18:33:45.121-04,6,13,19
5396,10,2011-08-22 18:33:45.121-04,5,14,19
5397,11,2011-08-22 18:33:45.121-04,0,15,15
5398,12,2011-08-22 18:33:45.121-04,10,5,15
5399,13,2011-08-22 18:33:45.121-04,0,14,14
5400,14,2011-08-22 18:33:45.121-04,0,17,17
5401,15,2011-08-22 18:33:45.121-04,8,7,15
5402,16,2011-08-22 18:33:45.121-04,13,6,19
5403,17,2011-08-22 18:33:45.121-04,5,10,15
5404,18,2011-08-22 18:33:45.121-04,6,9,15
5405,20,2011-08-22 18:33:45.121-04,7,12,19
5406,21,2011-08-22 18:33:45.121-04,5,18,23
5407,22,2011-08-22 18:33:45.121-04,24,23,47
5408,23,2011-08-22 18:33:45.121-04,4,14,18
5409,24,2011-08-22 18:33:45.121-04,3,12,15
5410,25,2011-08-22 18:33:45.121-04,12,3,15
5411,26,2011-08-22 18:33:45.121-04,7,8,15
5412,27,2011-08-22 18:33:45.121-04,7,7,14
5413,30,2011-08-22 18:33:45.121-04,11,4,15
5414,31,2011-08-22 18:33:45.121-04,4,7,11
5415,32,2011-08-22 18:33:45.121-04,8,3,11
5416,33,2011-08-22 18:33:45.121-04,4,15,19
5417,34,2011-08-22 18:33:45.121-04,8,7,15
5418,35,2011-08-22 18:33:45.121-04,1,10,11
5419,36,2011-08-22 18:33:45.121-04,6,9,15
5420,37,2011-08-22 18:33:45.121-04,8,7,15
5421,38,2011-08-22 18:33:45.121-04,26,9,35
5422,39,2011-08-22 18:33:45.121-04,8,11,19
5423,40,2011-08-22 18:33:45.121-04,10,3,13
5424,41,2011-08-22 18:33:45.121-04,12,7,19
5425,42,2011-08-22 18:33:45.121-04,6,13,19
5426,43,2011-08-22 18:33:45.121-04,3,12,15
5427,44,2011-08-22 18:33:45.121-04,14,5,19
5428,45,2011-08-22 18:33:45.121-04,5,14,19
5429,46,2011-08-22 18:33:45.121-04,13,6,19
5430,47,2011-08-22 18:33:45.121-04,11,0,11
5431,48,2011-08-22 18:33:45.121-04,3,12,15
5432,49,2011-08-22 18:33:45.121-04,8,7,15
5433,50,2011-08-22 18:33:45.121-04,0,15,15
5434,51,2011-08-22 18:33:45.121-04,6,9,15
5435,52,2011-08-22 18:33:45.121-04,7,7,14
5436,53,2011-08-22 18:33:45.121-04,10,5,15
5437,55,2011-08-22 18:33:45.121-04,4,11,15
5438,56,2011-08-22 18:33:45.121-04,4,11,15
5439,57,2011-08-22 18:33:45.121-04,7,4,11
5440,3,2011-08-22 18:34:45.992-04,9,8,17
5441,5,2011-08-22 18:34:45.992-04,0,15,15
5442,6,2011-08-22 18:34:45.992-04,11,4,15
5443,8,2011-08-22 18:34:45.992-04,6,9,15
5444,9,2011-08-22 18:34:45.992-04,6,13,19
5445,10,2011-08-22 18:34:45.992-04,5,14,19
5446,11,2011-08-22 18:34:45.992-04,0,15,15
5447,12,2011-08-22 18:34:45.992-04,10,5,15
5448,13,2011-08-22 18:34:45.992-04,0,14,14
5449,14,2011-08-22 18:34:45.992-04,0,17,17
5450,15,2011-08-22 18:34:45.992-04,8,7,15
5451,16,2011-08-22 18:34:45.992-04,13,6,19
5452,17,2011-08-22 18:34:45.992-04,5,10,15
5453,18,2011-08-22 18:34:45.992-04,6,9,15
5454,20,2011-08-22 18:34:45.992-04,7,12,19
5455,21,2011-08-22 18:34:45.992-04,5,18,23
5456,22,2011-08-22 18:34:45.992-04,24,23,47
5457,23,2011-08-22 18:34:45.992-04,4,14,18
5458,24,2011-08-22 18:34:45.992-04,2,13,15
5459,25,2011-08-22 18:34:45.992-04,12,3,15
5460,26,2011-08-22 18:34:45.992-04,7,8,15
5461,27,2011-08-22 18:34:45.992-04,7,7,14
5462,30,2011-08-22 18:34:45.992-04,11,4,15
5463,31,2011-08-22 18:34:45.992-04,4,7,11
5464,32,2011-08-22 18:34:45.992-04,8,3,11
5465,33,2011-08-22 18:34:45.992-04,4,15,19
5466,34,2011-08-22 18:34:45.992-04,8,7,15
5467,35,2011-08-22 18:34:45.992-04,1,10,11
5468,36,2011-08-22 18:34:45.992-04,6,9,15
5469,37,2011-08-22 18:34:45.992-04,8,7,15
5470,38,2011-08-22 18:34:45.992-04,26,9,35
5471,39,2011-08-22 18:34:45.992-04,8,11,19
5472,40,2011-08-22 18:34:45.992-04,10,3,13
5473,41,2011-08-22 18:34:45.992-04,12,7,19
5474,42,2011-08-22 18:34:45.992-04,6,13,19
5475,43,2011-08-22 18:34:45.992-04,3,12,15
5476,44,2011-08-22 18:34:45.992-04,14,5,19
5477,45,2011-08-22 18:34:45.992-04,5,14,19
5478,46,2011-08-22 18:34:45.992-04,13,6,19
5479,47,2011-08-22 18:34:45.992-04,11,0,11
5480,48,2011-08-22 18:34:45.992-04,3,12,15
5481,49,2011-08-22 18:34:45.992-04,8,7,15
5482,50,2011-08-22 18:34:45.992-04,3,12,15
5483,51,2011-08-22 18:34:45.992-04,6,9,15
5484,52,2011-08-22 18:34:45.992-04,8,6,14
5485,53,2011-08-22 18:34:45.992-04,10,5,15
5486,55,2011-08-22 18:34:45.992-04,4,11,15
5487,56,2011-08-22 18:34:45.992-04,4,11,15
5488,57,2011-08-22 18:34:45.992-04,7,4,11
5489,3,2011-08-22 18:35:46.893-04,9,8,17
5490,5,2011-08-22 18:35:46.893-04,0,15,15
5491,6,2011-08-22 18:35:46.893-04,11,4,15
5492,8,2011-08-22 18:35:46.893-04,6,9,15
5493,9,2011-08-22 18:35:46.893-04,6,13,19
5494,10,2011-08-22 18:35:46.893-04,5,14,19
5495,11,2011-08-22 18:35:46.893-04,0,15,15
5496,12,2011-08-22 18:35:46.893-04,10,5,15
5497,13,2011-08-22 18:35:46.893-04,0,14,14
5498,14,2011-08-22 18:35:46.893-04,0,17,17
5499,15,2011-08-22 18:35:46.893-04,8,7,15
5500,16,2011-08-22 18:35:46.893-04,13,6,19
5501,17,2011-08-22 18:35:46.893-04,5,10,15
5502,18,2011-08-22 18:35:46.893-04,6,9,15
5503,20,2011-08-22 18:35:46.893-04,7,12,19
5504,21,2011-08-22 18:35:46.893-04,5,18,23
5505,22,2011-08-22 18:35:46.893-04,25,22,47
5506,23,2011-08-22 18:35:46.893-04,4,14,18
5507,24,2011-08-22 18:35:46.893-04,2,13,15
5508,25,2011-08-22 18:35:46.893-04,12,3,15
5509,26,2011-08-22 18:35:46.893-04,7,8,15
5510,27,2011-08-22 18:35:46.893-04,7,7,14
5511,30,2011-08-22 18:35:46.893-04,11,4,15
5512,31,2011-08-22 18:35:46.893-04,4,7,11
5513,32,2011-08-22 18:35:46.893-04,8,3,11
5514,33,2011-08-22 18:35:46.893-04,4,15,19
5515,34,2011-08-22 18:35:46.893-04,8,7,15
5516,35,2011-08-22 18:35:46.893-04,1,10,11
5517,36,2011-08-22 18:35:46.893-04,6,9,15
5518,37,2011-08-22 18:35:46.893-04,8,7,15
5519,38,2011-08-22 18:35:46.893-04,26,9,35
5520,39,2011-08-22 18:35:46.893-04,8,11,19
5521,40,2011-08-22 18:35:46.893-04,10,3,13
5522,41,2011-08-22 18:35:46.893-04,12,7,19
5523,42,2011-08-22 18:35:46.893-04,5,14,19
5524,43,2011-08-22 18:35:46.893-04,3,12,15
5525,44,2011-08-22 18:35:46.893-04,14,5,19
5526,45,2011-08-22 18:35:46.893-04,5,14,19
5527,46,2011-08-22 18:35:46.893-04,13,6,19
5528,47,2011-08-22 18:35:46.893-04,11,0,11
5529,48,2011-08-22 18:35:46.893-04,3,12,15
5530,49,2011-08-22 18:35:46.893-04,8,7,15
5531,50,2011-08-22 18:35:46.893-04,3,12,15
5532,51,2011-08-22 18:35:46.893-04,6,9,15
5533,52,2011-08-22 18:35:46.893-04,8,6,14
5534,53,2011-08-22 18:35:46.893-04,9,6,15
5535,55,2011-08-22 18:35:46.893-04,4,11,15
5536,56,2011-08-22 18:35:46.893-04,4,11,15
5537,57,2011-08-22 18:35:46.893-04,7,4,11
5538,3,2011-08-22 18:36:47.802-04,9,8,17
5539,5,2011-08-22 18:36:47.802-04,1,14,15
5540,6,2011-08-22 18:36:47.802-04,12,3,15
5541,8,2011-08-22 18:36:47.802-04,6,9,15
5542,9,2011-08-22 18:36:47.802-04,6,13,19
5543,10,2011-08-22 18:36:47.802-04,5,14,19
5544,11,2011-08-22 18:36:47.802-04,0,15,15
5545,12,2011-08-22 18:36:47.802-04,10,5,15
5546,13,2011-08-22 18:36:47.802-04,0,14,14
5547,14,2011-08-22 18:36:47.802-04,0,17,17
5548,15,2011-08-22 18:36:47.802-04,8,7,15
5549,16,2011-08-22 18:36:47.802-04,13,6,19
5550,17,2011-08-22 18:36:47.802-04,5,10,15
5551,18,2011-08-22 18:36:47.802-04,6,9,15
5552,20,2011-08-22 18:36:47.802-04,7,12,19
5553,21,2011-08-22 18:36:47.802-04,5,18,23
5554,22,2011-08-22 18:36:47.802-04,25,22,47
5555,23,2011-08-22 18:36:47.802-04,5,13,18
5556,24,2011-08-22 18:36:47.802-04,0,15,15
5557,25,2011-08-22 18:36:47.802-04,12,3,15
5558,26,2011-08-22 18:36:47.802-04,7,8,15
5559,27,2011-08-22 18:36:47.802-04,7,7,14
5560,30,2011-08-22 18:36:47.802-04,11,4,15
5561,31,2011-08-22 18:36:47.802-04,5,6,11
5562,32,2011-08-22 18:36:47.802-04,8,3,11
5563,33,2011-08-22 18:36:47.802-04,4,15,19
5564,34,2011-08-22 18:36:47.802-04,8,7,15
5565,35,2011-08-22 18:36:47.802-04,1,10,11
5566,36,2011-08-22 18:36:47.802-04,6,9,15
5567,37,2011-08-22 18:36:47.802-04,8,7,15
5568,38,2011-08-22 18:36:47.802-04,27,8,35
5569,39,2011-08-22 18:36:47.802-04,9,10,19
5570,40,2011-08-22 18:36:47.802-04,11,2,13
5571,41,2011-08-22 18:36:47.802-04,12,7,19
5572,42,2011-08-22 18:36:47.802-04,5,14,19
5573,43,2011-08-22 18:36:47.802-04,3,12,15
5574,44,2011-08-22 18:36:47.802-04,14,5,19
5575,45,2011-08-22 18:36:47.802-04,5,14,19
5576,46,2011-08-22 18:36:47.802-04,13,6,19
5577,47,2011-08-22 18:36:47.802-04,11,0,11
5578,48,2011-08-22 18:36:47.802-04,3,12,15
5579,49,2011-08-22 18:36:47.802-04,8,7,15
5580,50,2011-08-22 18:36:47.802-04,3,12,15
5581,51,2011-08-22 18:36:47.802-04,6,9,15
5582,52,2011-08-22 18:36:47.802-04,7,7,14
5583,53,2011-08-22 18:36:47.802-04,8,7,15
5584,55,2011-08-22 18:36:47.802-04,4,11,15
5585,56,2011-08-22 18:36:47.802-04,4,11,15
5586,57,2011-08-22 18:36:47.802-04,7,4,11
5587,3,2011-08-22 18:37:48.642-04,9,8,17
5588,5,2011-08-22 18:37:48.642-04,2,13,15
5589,6,2011-08-22 18:37:48.642-04,12,3,15
5590,8,2011-08-22 18:37:48.642-04,6,9,15
5591,9,2011-08-22 18:37:48.642-04,6,13,19
5592,10,2011-08-22 18:37:48.642-04,5,14,19
5593,11,2011-08-22 18:37:48.642-04,1,14,15
5594,12,2011-08-22 18:37:48.642-04,10,5,15
5595,13,2011-08-22 18:37:48.642-04,0,14,14
5596,14,2011-08-22 18:37:48.642-04,0,17,17
5597,15,2011-08-22 18:37:48.642-04,8,7,15
5598,16,2011-08-22 18:37:48.642-04,13,6,19
5599,17,2011-08-22 18:37:48.642-04,5,10,15
5600,18,2011-08-22 18:37:48.642-04,6,9,15
5601,20,2011-08-22 18:37:48.642-04,7,12,19
5602,21,2011-08-22 18:37:48.642-04,6,17,23
5603,22,2011-08-22 18:37:48.642-04,25,22,47
5604,23,2011-08-22 18:37:48.642-04,5,13,18
5605,24,2011-08-22 18:37:48.642-04,0,15,15
5606,25,2011-08-22 18:37:48.642-04,12,3,15
5607,26,2011-08-22 18:37:48.642-04,7,8,15
5608,27,2011-08-22 18:37:48.642-04,7,7,14
5609,30,2011-08-22 18:37:48.642-04,11,4,15
5610,31,2011-08-22 18:37:48.642-04,5,6,11
5611,32,2011-08-22 18:37:48.642-04,8,3,11
5612,33,2011-08-22 18:37:48.642-04,4,15,19
5613,34,2011-08-22 18:37:48.642-04,8,7,15
5614,35,2011-08-22 18:37:48.642-04,1,10,11
5615,36,2011-08-22 18:37:48.642-04,6,9,15
5616,37,2011-08-22 18:37:48.642-04,8,7,15
5617,38,2011-08-22 18:37:48.642-04,27,8,35
5618,39,2011-08-22 18:37:48.642-04,9,10,19
5619,40,2011-08-22 18:37:48.642-04,11,2,13
5620,41,2011-08-22 18:37:48.642-04,15,4,19
5621,42,2011-08-22 18:37:48.642-04,5,14,19
5622,43,2011-08-22 18:37:48.642-04,3,12,15
5623,44,2011-08-22 18:37:48.642-04,14,5,19
5624,45,2011-08-22 18:37:48.642-04,5,14,19
5625,46,2011-08-22 18:37:48.642-04,13,6,19
5626,47,2011-08-22 18:37:48.642-04,11,0,11
5627,48,2011-08-22 18:37:48.642-04,3,12,15
5628,49,2011-08-22 18:37:48.642-04,8,7,15
5629,50,2011-08-22 18:37:48.642-04,3,12,15
5630,51,2011-08-22 18:37:48.642-04,6,9,15
5631,52,2011-08-22 18:37:48.642-04,7,7,14
5632,53,2011-08-22 18:37:48.642-04,9,6,15
5633,55,2011-08-22 18:37:48.642-04,4,11,15
5634,56,2011-08-22 18:37:48.642-04,4,11,15
5635,57,2011-08-22 18:37:48.642-04,7,4,11
5636,3,2011-08-22 18:38:49.608-04,9,8,17
5637,5,2011-08-22 18:38:49.608-04,2,13,15
5638,6,2011-08-22 18:38:49.608-04,12,3,15
5639,8,2011-08-22 18:38:49.608-04,6,9,15
5640,9,2011-08-22 18:38:49.608-04,6,13,19
5641,10,2011-08-22 18:38:49.608-04,5,14,19
5642,11,2011-08-22 18:38:49.608-04,1,14,15
5643,12,2011-08-22 18:38:49.608-04,10,5,15
5644,13,2011-08-22 18:38:49.608-04,0,14,14
5645,14,2011-08-22 18:38:49.608-04,0,17,17
5646,15,2011-08-22 18:38:49.608-04,8,7,15
5647,16,2011-08-22 18:38:49.608-04,13,6,19
5648,17,2011-08-22 18:38:49.608-04,5,10,15
5649,18,2011-08-22 18:38:49.608-04,6,9,15
5650,20,2011-08-22 18:38:49.608-04,7,12,19
5651,21,2011-08-22 18:38:49.608-04,6,17,23
5652,22,2011-08-22 18:38:49.608-04,25,22,47
5653,23,2011-08-22 18:38:49.608-04,5,13,18
5654,24,2011-08-22 18:38:49.608-04,0,15,15
5655,25,2011-08-22 18:38:49.608-04,12,3,15
5656,26,2011-08-22 18:38:49.608-04,7,8,15
5657,27,2011-08-22 18:38:49.608-04,7,7,14
5658,30,2011-08-22 18:38:49.608-04,11,4,15
5659,31,2011-08-22 18:38:49.608-04,5,6,11
5660,32,2011-08-22 18:38:49.608-04,8,3,11
5661,33,2011-08-22 18:38:49.608-04,4,15,19
5662,34,2011-08-22 18:38:49.608-04,8,7,15
5663,35,2011-08-22 18:38:49.608-04,1,10,11
5664,36,2011-08-22 18:38:49.608-04,6,9,15
5665,37,2011-08-22 18:38:49.608-04,8,7,15
5666,38,2011-08-22 18:38:49.608-04,27,8,35
5667,39,2011-08-22 18:38:49.608-04,9,10,19
5668,40,2011-08-22 18:38:49.608-04,11,2,13
5669,41,2011-08-22 18:38:49.608-04,15,4,19
5670,42,2011-08-22 18:38:49.608-04,4,15,19
5671,43,2011-08-22 18:38:49.608-04,3,12,15
5672,44,2011-08-22 18:38:49.608-04,14,5,19
5673,45,2011-08-22 18:38:49.608-04,5,14,19
5674,46,2011-08-22 18:38:49.608-04,13,6,19
5675,47,2011-08-22 18:38:49.608-04,11,0,11
5676,48,2011-08-22 18:38:49.608-04,3,12,15
5677,49,2011-08-22 18:38:49.608-04,8,7,15
5678,50,2011-08-22 18:38:49.608-04,3,12,15
5679,51,2011-08-22 18:38:49.608-04,6,9,15
5680,52,2011-08-22 18:38:49.608-04,8,6,14
5681,53,2011-08-22 18:38:49.608-04,9,6,15
5682,55,2011-08-22 18:38:49.608-04,4,11,15
5683,56,2011-08-22 18:38:49.608-04,4,11,15
5684,57,2011-08-22 18:38:49.608-04,7,4,11
5685,3,2011-08-22 18:39:50.507-04,9,8,17
5686,5,2011-08-22 18:39:50.507-04,2,13,15
5687,6,2011-08-22 18:39:50.507-04,12,3,15
5688,8,2011-08-22 18:39:50.507-04,5,10,15
5689,9,2011-08-22 18:39:50.507-04,6,13,19
5690,10,2011-08-22 18:39:50.507-04,5,14,19
5691,11,2011-08-22 18:39:50.507-04,1,14,15
5692,12,2011-08-22 18:39:50.507-04,10,5,15
5693,13,2011-08-22 18:39:50.507-04,0,14,14
5694,14,2011-08-22 18:39:50.507-04,0,17,17
5695,15,2011-08-22 18:39:50.507-04,8,7,15
5696,16,2011-08-22 18:39:50.507-04,13,6,19
5697,17,2011-08-22 18:39:50.507-04,5,10,15
5698,18,2011-08-22 18:39:50.507-04,6,9,15
5699,20,2011-08-22 18:39:50.507-04,7,12,19
5700,21,2011-08-22 18:39:50.507-04,5,18,23
5701,22,2011-08-22 18:39:50.507-04,25,22,47
5702,23,2011-08-22 18:39:50.507-04,5,13,18
5703,24,2011-08-22 18:39:50.507-04,0,15,15
5704,25,2011-08-22 18:39:50.507-04,12,3,15
5705,26,2011-08-22 18:39:50.507-04,7,8,15
5706,27,2011-08-22 18:39:50.507-04,7,7,14
5707,30,2011-08-22 18:39:50.507-04,11,4,15
5708,31,2011-08-22 18:39:50.507-04,5,6,11
5709,32,2011-08-22 18:39:50.507-04,8,3,11
5710,33,2011-08-22 18:39:50.507-04,4,15,19
5711,34,2011-08-22 18:39:50.507-04,8,7,15
5712,35,2011-08-22 18:39:50.507-04,1,10,11
5713,36,2011-08-22 18:39:50.507-04,6,9,15
5714,37,2011-08-22 18:39:50.507-04,8,7,15
5715,38,2011-08-22 18:39:50.507-04,27,8,35
5716,39,2011-08-22 18:39:50.507-04,9,10,19
5717,40,2011-08-22 18:39:50.507-04,11,2,13
5718,41,2011-08-22 18:39:50.507-04,15,4,19
5719,42,2011-08-22 18:39:50.507-04,4,15,19
5720,43,2011-08-22 18:39:50.507-04,3,12,15
5721,44,2011-08-22 18:39:50.507-04,14,5,19
5722,45,2011-08-22 18:39:50.507-04,5,14,19
5723,46,2011-08-22 18:39:50.507-04,13,6,19
5724,47,2011-08-22 18:39:50.507-04,11,0,11
5725,48,2011-08-22 18:39:50.507-04,3,12,15
5726,49,2011-08-22 18:39:50.507-04,8,7,15
5727,50,2011-08-22 18:39:50.507-04,3,12,15
5728,51,2011-08-22 18:39:50.507-04,6,9,15
5729,52,2011-08-22 18:39:50.507-04,8,6,14
5730,53,2011-08-22 18:39:50.507-04,10,5,15
5731,55,2011-08-22 18:39:50.507-04,4,11,15
5732,56,2011-08-22 18:39:50.507-04,4,11,15
5733,57,2011-08-22 18:39:50.507-04,7,4,11
5734,3,2011-08-22 18:40:51.396-04,9,8,17
5735,5,2011-08-22 18:40:51.396-04,2,13,15
5736,6,2011-08-22 18:40:51.396-04,12,3,15
5737,8,2011-08-22 18:40:51.396-04,4,11,15
5738,9,2011-08-22 18:40:51.396-04,6,13,19
5739,10,2011-08-22 18:40:51.396-04,5,14,19
5740,11,2011-08-22 18:40:51.396-04,1,14,15
5741,12,2011-08-22 18:40:51.396-04,10,5,15
5742,13,2011-08-22 18:40:51.396-04,2,12,14
5743,14,2011-08-22 18:40:51.396-04,0,17,17
5744,15,2011-08-22 18:40:51.396-04,8,7,15
5745,16,2011-08-22 18:40:51.396-04,13,6,19
5746,17,2011-08-22 18:40:51.396-04,5,10,15
5747,18,2011-08-22 18:40:51.396-04,6,9,15
5748,20,2011-08-22 18:40:51.396-04,7,12,19
5749,21,2011-08-22 18:40:51.396-04,5,18,23
5750,22,2011-08-22 18:40:51.396-04,24,23,47
5751,23,2011-08-22 18:40:51.396-04,5,13,18
5752,24,2011-08-22 18:40:51.396-04,0,15,15
5753,25,2011-08-22 18:40:51.396-04,12,3,15
5754,26,2011-08-22 18:40:51.396-04,7,8,15
5755,27,2011-08-22 18:40:51.396-04,7,7,14
5756,30,2011-08-22 18:40:51.396-04,11,4,15
5757,31,2011-08-22 18:40:51.396-04,5,6,11
5758,32,2011-08-22 18:40:51.396-04,8,3,11
5759,33,2011-08-22 18:40:51.396-04,4,15,19
5760,34,2011-08-22 18:40:51.396-04,8,7,15
5761,35,2011-08-22 18:40:51.396-04,1,10,11
5762,36,2011-08-22 18:40:51.396-04,6,9,15
5763,37,2011-08-22 18:40:51.396-04,8,7,15
5764,38,2011-08-22 18:40:51.396-04,27,8,35
5765,39,2011-08-22 18:40:51.396-04,9,10,19
5766,40,2011-08-22 18:40:51.396-04,11,2,13
5767,41,2011-08-22 18:40:51.396-04,15,4,19
5768,42,2011-08-22 18:40:51.396-04,4,15,19
5769,43,2011-08-22 18:40:51.396-04,3,12,15
5770,44,2011-08-22 18:40:51.396-04,15,4,19
5771,45,2011-08-22 18:40:51.396-04,5,14,19
5772,46,2011-08-22 18:40:51.396-04,14,5,19
5773,47,2011-08-22 18:40:51.396-04,11,0,11
5774,48,2011-08-22 18:40:51.396-04,3,12,15
5775,49,2011-08-22 18:40:51.396-04,8,7,15
5776,50,2011-08-22 18:40:51.396-04,3,12,15
5777,51,2011-08-22 18:40:51.396-04,6,9,15
5778,52,2011-08-22 18:40:51.396-04,8,6,14
5779,53,2011-08-22 18:40:51.396-04,10,5,15
5780,55,2011-08-22 18:40:51.396-04,4,11,15
5781,56,2011-08-22 18:40:51.396-04,4,11,15
5782,57,2011-08-22 18:40:51.396-04,7,4,11
5783,3,2011-08-22 18:41:52.343-04,9,8,17
5784,5,2011-08-22 18:41:52.343-04,2,13,15
5785,6,2011-08-22 18:41:52.343-04,12,3,15
5786,8,2011-08-22 18:41:52.343-04,4,11,15
5787,9,2011-08-22 18:41:52.343-04,6,13,19
5788,10,2011-08-22 18:41:52.343-04,5,14,19
5789,11,2011-08-22 18:41:52.343-04,1,14,15
5790,12,2011-08-22 18:41:52.343-04,10,5,15
5791,13,2011-08-22 18:41:52.343-04,4,10,14
5792,14,2011-08-22 18:41:52.343-04,0,17,17
5793,15,2011-08-22 18:41:52.343-04,8,7,15
5794,16,2011-08-22 18:41:52.343-04,13,6,19
5795,17,2011-08-22 18:41:52.343-04,5,10,15
5796,18,2011-08-22 18:41:52.343-04,6,9,15
5797,20,2011-08-22 18:41:52.343-04,7,12,19
5798,21,2011-08-22 18:41:52.343-04,5,18,23
5799,22,2011-08-22 18:41:52.343-04,24,23,47
5800,23,2011-08-22 18:41:52.343-04,4,14,18
5801,24,2011-08-22 18:41:52.343-04,0,15,15
5802,25,2011-08-22 18:41:52.343-04,12,3,15
5803,26,2011-08-22 18:41:52.343-04,7,8,15
5804,27,2011-08-22 18:41:52.343-04,7,7,14
5805,30,2011-08-22 18:41:52.343-04,11,4,15
5806,31,2011-08-22 18:41:52.343-04,5,6,11
5807,32,2011-08-22 18:41:52.343-04,8,3,11
5808,33,2011-08-22 18:41:52.343-04,4,15,19
5809,34,2011-08-22 18:41:52.343-04,8,7,15
5810,35,2011-08-22 18:41:52.343-04,1,10,11
5811,36,2011-08-22 18:41:52.343-04,6,9,15
5812,37,2011-08-22 18:41:52.343-04,8,7,15
5813,38,2011-08-22 18:41:52.343-04,27,8,35
5814,39,2011-08-22 18:41:52.343-04,9,10,19
5815,40,2011-08-22 18:41:52.343-04,11,2,13
5816,41,2011-08-22 18:41:52.343-04,15,4,19
5817,42,2011-08-22 18:41:52.343-04,4,15,19
5818,43,2011-08-22 18:41:52.343-04,3,12,15
5819,44,2011-08-22 18:41:52.343-04,15,4,19
5820,45,2011-08-22 18:41:52.343-04,6,13,19
5821,46,2011-08-22 18:41:52.343-04,14,5,19
5822,47,2011-08-22 18:41:52.343-04,11,0,11
5823,48,2011-08-22 18:41:52.343-04,2,13,15
5824,49,2011-08-22 18:41:52.343-04,8,7,15
5825,50,2011-08-22 18:41:52.343-04,3,12,15
5826,51,2011-08-22 18:41:52.343-04,6,9,15
5827,52,2011-08-22 18:41:52.343-04,8,6,14
5828,53,2011-08-22 18:41:52.343-04,10,5,15
5829,55,2011-08-22 18:41:52.343-04,4,11,15
5830,56,2011-08-22 18:41:52.343-04,4,11,15
5831,57,2011-08-22 18:41:52.343-04,7,4,11
5832,3,2011-08-22 18:42:53.778-04,9,8,17
5833,5,2011-08-22 18:42:53.778-04,2,13,15
5834,6,2011-08-22 18:42:53.778-04,12,3,15
5835,8,2011-08-22 18:42:53.778-04,2,13,15
5836,9,2011-08-22 18:42:53.778-04,6,13,19
5837,10,2011-08-22 18:42:53.778-04,5,14,19
5838,11,2011-08-22 18:42:53.778-04,1,14,15
5839,12,2011-08-22 18:42:53.778-04,10,5,15
5840,13,2011-08-22 18:42:53.778-04,6,8,14
5841,14,2011-08-22 18:42:53.778-04,0,17,17
5842,15,2011-08-22 18:42:53.778-04,8,7,15
5843,16,2011-08-22 18:42:53.778-04,13,6,19
5844,17,2011-08-22 18:42:53.778-04,5,10,15
5845,18,2011-08-22 18:42:53.778-04,5,10,15
5846,20,2011-08-22 18:42:53.778-04,7,12,19
5847,21,2011-08-22 18:42:53.778-04,5,18,23
5848,22,2011-08-22 18:42:53.778-04,24,23,47
5849,23,2011-08-22 18:42:53.778-04,4,14,18
5850,24,2011-08-22 18:42:53.778-04,0,15,15
5851,25,2011-08-22 18:42:53.778-04,12,3,15
5852,26,2011-08-22 18:42:53.778-04,7,8,15
5853,27,2011-08-22 18:42:53.778-04,7,7,14
5854,30,2011-08-22 18:42:53.778-04,11,4,15
5855,31,2011-08-22 18:42:53.778-04,5,6,11
5856,32,2011-08-22 18:42:53.778-04,7,4,11
5857,33,2011-08-22 18:42:53.778-04,4,15,19
5858,34,2011-08-22 18:42:53.778-04,8,7,15
5859,35,2011-08-22 18:42:53.778-04,1,10,11
5860,36,2011-08-22 18:42:53.778-04,6,9,15
5861,37,2011-08-22 18:42:53.778-04,8,7,15
5862,38,2011-08-22 18:42:53.778-04,27,8,35
5863,39,2011-08-22 18:42:53.778-04,9,10,19
5864,40,2011-08-22 18:42:53.778-04,11,2,13
5865,41,2011-08-22 18:42:53.778-04,16,3,19
5866,42,2011-08-22 18:42:53.778-04,4,15,19
5867,43,2011-08-22 18:42:53.778-04,3,12,15
5868,44,2011-08-22 18:42:53.778-04,15,4,19
5869,45,2011-08-22 18:42:53.778-04,6,13,19
5870,46,2011-08-22 18:42:53.778-04,14,5,19
5871,47,2011-08-22 18:42:53.778-04,11,0,11
5872,48,2011-08-22 18:42:53.778-04,2,13,15
5873,49,2011-08-22 18:42:53.778-04,8,7,15
5874,50,2011-08-22 18:42:53.778-04,3,12,15
5875,51,2011-08-22 18:42:53.778-04,6,9,15
5876,52,2011-08-22 18:42:53.778-04,8,6,14
5877,53,2011-08-22 18:42:53.778-04,10,5,15
5878,55,2011-08-22 18:42:53.778-04,4,11,15
5879,56,2011-08-22 18:42:53.778-04,4,11,15
5880,57,2011-08-22 18:42:53.778-04,7,4,11
5881,3,2011-08-22 18:43:54.9-04,9,8,17
5882,5,2011-08-22 18:43:54.9-04,2,13,15
5883,6,2011-08-22 18:43:54.9-04,12,3,15
5884,8,2011-08-22 18:43:54.9-04,2,13,15
5885,9,2011-08-22 18:43:54.9-04,6,13,19
5886,10,2011-08-22 18:43:54.9-04,5,14,19
5887,11,2011-08-22 18:43:54.9-04,1,14,15
5888,12,2011-08-22 18:43:54.9-04,10,5,15
5889,13,2011-08-22 18:43:54.9-04,7,8,15
5890,14,2011-08-22 18:43:54.9-04,0,17,17
5891,15,2011-08-22 18:43:54.9-04,8,7,15
5892,16,2011-08-22 18:43:54.9-04,13,6,19
5893,17,2011-08-22 18:43:54.9-04,5,10,15
5894,18,2011-08-22 18:43:54.9-04,5,10,15
5895,20,2011-08-22 18:43:54.9-04,7,12,19
5896,21,2011-08-22 18:43:54.9-04,5,18,23
5897,22,2011-08-22 18:43:54.9-04,24,23,47
5898,23,2011-08-22 18:43:54.9-04,4,14,18
5899,24,2011-08-22 18:43:54.9-04,0,15,15
5900,25,2011-08-22 18:43:54.9-04,12,3,15
5901,26,2011-08-22 18:43:54.9-04,7,8,15
5902,27,2011-08-22 18:43:54.9-04,7,7,14
5903,30,2011-08-22 18:43:54.9-04,11,4,15
5904,31,2011-08-22 18:43:54.9-04,5,6,11
5905,32,2011-08-22 18:43:54.9-04,7,4,11
5906,33,2011-08-22 18:43:54.9-04,4,15,19
5907,34,2011-08-22 18:43:54.9-04,8,7,15
5908,35,2011-08-22 18:43:54.9-04,1,10,11
5909,36,2011-08-22 18:43:54.9-04,6,9,15
5910,37,2011-08-22 18:43:54.9-04,8,7,15
5911,38,2011-08-22 18:43:54.9-04,27,8,35
5912,39,2011-08-22 18:43:54.9-04,9,10,19
5913,40,2011-08-22 18:43:54.9-04,11,2,13
5914,41,2011-08-22 18:43:54.9-04,16,3,19
5915,42,2011-08-22 18:43:54.9-04,4,15,19
5916,43,2011-08-22 18:43:54.9-04,3,12,15
5917,44,2011-08-22 18:43:54.9-04,15,4,19
5918,45,2011-08-22 18:43:54.9-04,6,13,19
5919,46,2011-08-22 18:43:54.9-04,14,5,19
5920,47,2011-08-22 18:43:54.9-04,11,0,11
5921,48,2011-08-22 18:43:54.9-04,2,13,15
5922,49,2011-08-22 18:43:54.9-04,9,6,15
5923,50,2011-08-22 18:43:54.9-04,3,12,15
5924,51,2011-08-22 18:43:54.9-04,6,9,15
5925,52,2011-08-22 18:43:54.9-04,8,6,14
5926,53,2011-08-22 18:43:54.9-04,10,5,15
5927,55,2011-08-22 18:43:54.9-04,4,11,15
5928,56,2011-08-22 18:43:54.9-04,4,11,15
5929,57,2011-08-22 18:43:54.9-04,7,4,11
5930,3,2011-08-22 18:44:55.817-04,9,8,17
5931,5,2011-08-22 18:44:55.817-04,2,13,15
5932,6,2011-08-22 18:44:55.817-04,12,3,15
5933,8,2011-08-22 18:44:55.817-04,2,13,15
5934,9,2011-08-22 18:44:55.817-04,6,13,19
5935,10,2011-08-22 18:44:55.817-04,5,14,19
5936,11,2011-08-22 18:44:55.817-04,1,14,15
5937,12,2011-08-22 18:44:55.817-04,10,5,15
5938,13,2011-08-22 18:44:55.817-04,7,8,15
5939,14,2011-08-22 18:44:55.817-04,0,17,17
5940,15,2011-08-22 18:44:55.817-04,8,7,15
5941,16,2011-08-22 18:44:55.817-04,13,6,19
5942,17,2011-08-22 18:44:55.817-04,5,10,15
5943,18,2011-08-22 18:44:55.817-04,5,10,15
5944,20,2011-08-22 18:44:55.817-04,7,12,19
5945,21,2011-08-22 18:44:55.817-04,5,18,23
5946,22,2011-08-22 18:44:55.817-04,24,23,47
5947,23,2011-08-22 18:44:55.817-04,4,14,18
5948,24,2011-08-22 18:44:55.817-04,0,15,15
5949,25,2011-08-22 18:44:55.817-04,12,3,15
5950,26,2011-08-22 18:44:55.817-04,7,8,15
5951,27,2011-08-22 18:44:55.817-04,7,7,14
5952,30,2011-08-22 18:44:55.817-04,11,4,15
5953,31,2011-08-22 18:44:55.817-04,5,6,11
5954,32,2011-08-22 18:44:55.817-04,7,4,11
5955,33,2011-08-22 18:44:55.817-04,4,15,19
5956,34,2011-08-22 18:44:55.817-04,8,7,15
5957,35,2011-08-22 18:44:55.817-04,1,10,11
5958,36,2011-08-22 18:44:55.817-04,5,10,15
5959,37,2011-08-22 18:44:55.817-04,8,7,15
5960,38,2011-08-22 18:44:55.817-04,27,8,35
5961,39,2011-08-22 18:44:55.817-04,9,10,19
5962,40,2011-08-22 18:44:55.817-04,11,2,13
5963,41,2011-08-22 18:44:55.817-04,16,3,19
5964,42,2011-08-22 18:44:55.817-04,3,16,19
5965,43,2011-08-22 18:44:55.817-04,4,11,15
5966,44,2011-08-22 18:44:55.817-04,15,4,19
5967,45,2011-08-22 18:44:55.817-04,6,13,19
5968,46,2011-08-22 18:44:55.817-04,14,5,19
5969,47,2011-08-22 18:44:55.817-04,11,0,11
5970,48,2011-08-22 18:44:55.817-04,2,13,15
5971,49,2011-08-22 18:44:55.817-04,9,6,15
5972,50,2011-08-22 18:44:55.817-04,3,12,15
5973,51,2011-08-22 18:44:55.817-04,6,9,15
5974,52,2011-08-22 18:44:55.817-04,9,5,14
5975,53,2011-08-22 18:44:55.817-04,10,5,15
5976,55,2011-08-22 18:44:55.817-04,4,11,15
5977,56,2011-08-22 18:44:55.817-04,4,11,15
5978,57,2011-08-22 18:44:55.817-04,7,4,11
5979,3,2011-08-22 18:45:56.741-04,9,8,17
5980,5,2011-08-22 18:45:56.741-04,2,13,15
5981,6,2011-08-22 18:45:56.741-04,13,2,15
5982,8,2011-08-22 18:45:56.741-04,2,13,15
5983,9,2011-08-22 18:45:56.741-04,6,13,19
5984,10,2011-08-22 18:45:56.741-04,5,14,19
5985,11,2011-08-22 18:45:56.741-04,1,14,15
5986,12,2011-08-22 18:45:56.741-04,10,5,15
5987,13,2011-08-22 18:45:56.741-04,7,8,15
5988,14,2011-08-22 18:45:56.741-04,0,17,17
5989,15,2011-08-22 18:45:56.741-04,8,7,15
5990,16,2011-08-22 18:45:56.741-04,13,6,19
5991,17,2011-08-22 18:45:56.741-04,5,10,15
5992,18,2011-08-22 18:45:56.741-04,5,10,15
5993,20,2011-08-22 18:45:56.741-04,7,12,19
5994,21,2011-08-22 18:45:56.741-04,5,18,23
5995,22,2011-08-22 18:45:56.741-04,23,24,47
5996,23,2011-08-22 18:45:56.741-04,5,13,18
5997,24,2011-08-22 18:45:56.741-04,0,15,15
5998,25,2011-08-22 18:45:56.741-04,12,3,15
5999,26,2011-08-22 18:45:56.741-04,7,8,15
6000,27,2011-08-22 18:45:56.741-04,7,7,14
6001,30,2011-08-22 18:45:56.741-04,11,4,15
6002,31,2011-08-22 18:45:56.741-04,5,6,11
6003,32,2011-08-22 18:45:56.741-04,7,4,11
6004,33,2011-08-22 18:45:56.741-04,4,15,19
6005,34,2011-08-22 18:45:56.741-04,8,7,15
6006,35,2011-08-22 18:45:56.741-04,1,10,11
6007,36,2011-08-22 18:45:56.741-04,5,10,15
6008,37,2011-08-22 18:45:56.741-04,8,7,15
6009,38,2011-08-22 18:45:56.741-04,27,8,35
6010,39,2011-08-22 18:45:56.741-04,9,10,19
6011,40,2011-08-22 18:45:56.741-04,12,1,13
6012,41,2011-08-22 18:45:56.741-04,16,3,19
6013,42,2011-08-22 18:45:56.741-04,2,17,19
6014,43,2011-08-22 18:45:56.741-04,3,12,15
6015,44,2011-08-22 18:45:56.741-04,15,4,19
6016,45,2011-08-22 18:45:56.741-04,6,13,19
6017,46,2011-08-22 18:45:56.741-04,14,5,19
6018,47,2011-08-22 18:45:56.741-04,11,0,11
6019,48,2011-08-22 18:45:56.741-04,2,13,15
6020,49,2011-08-22 18:45:56.741-04,9,6,15
6021,50,2011-08-22 18:45:56.741-04,3,12,15
6022,51,2011-08-22 18:45:56.741-04,6,9,15
6023,52,2011-08-22 18:45:56.741-04,9,5,14
6024,53,2011-08-22 18:45:56.741-04,10,5,15
6025,55,2011-08-22 18:45:56.741-04,4,11,15
6026,56,2011-08-22 18:45:56.741-04,4,11,15
6027,57,2011-08-22 18:45:56.741-04,7,4,11
6028,3,2011-08-22 18:46:57.765-04,9,8,17
6029,5,2011-08-22 18:46:57.765-04,2,13,15
6030,6,2011-08-22 18:46:57.765-04,12,3,15
6031,8,2011-08-22 18:46:57.765-04,1,14,15
6032,9,2011-08-22 18:46:57.765-04,6,13,19
6033,10,2011-08-22 18:46:57.765-04,5,14,19
6034,11,2011-08-22 18:46:57.765-04,1,14,15
6035,12,2011-08-22 18:46:57.765-04,10,5,15
6036,13,2011-08-22 18:46:57.765-04,7,8,15
6037,14,2011-08-22 18:46:57.765-04,0,17,17
6038,15,2011-08-22 18:46:57.765-04,8,7,15
6039,16,2011-08-22 18:46:57.765-04,13,6,19
6040,17,2011-08-22 18:46:57.765-04,5,10,15
6041,18,2011-08-22 18:46:57.765-04,5,10,15
6042,20,2011-08-22 18:46:57.765-04,7,12,19
6043,21,2011-08-22 18:46:57.765-04,5,18,23
6044,22,2011-08-22 18:46:57.765-04,23,24,47
6045,23,2011-08-22 18:46:57.765-04,5,13,18
6046,24,2011-08-22 18:46:57.765-04,0,15,15
6047,25,2011-08-22 18:46:57.765-04,12,3,15
6048,26,2011-08-22 18:46:57.765-04,7,8,15
6049,27,2011-08-22 18:46:57.765-04,7,7,14
6050,30,2011-08-22 18:46:57.765-04,11,4,15
6051,31,2011-08-22 18:46:57.765-04,5,6,11
6052,32,2011-08-22 18:46:57.765-04,7,4,11
6053,33,2011-08-22 18:46:57.765-04,4,15,19
6054,34,2011-08-22 18:46:57.765-04,8,7,15
6055,35,2011-08-22 18:46:57.765-04,1,10,11
6056,36,2011-08-22 18:46:57.765-04,3,12,15
6057,37,2011-08-22 18:46:57.765-04,8,7,15
6058,38,2011-08-22 18:46:57.765-04,27,8,35
6059,39,2011-08-22 18:46:57.765-04,9,10,19
6060,40,2011-08-22 18:46:57.765-04,12,1,13
6061,41,2011-08-22 18:46:57.765-04,16,3,19
6062,42,2011-08-22 18:46:57.765-04,2,17,19
6063,43,2011-08-22 18:46:57.765-04,3,12,15
6064,44,2011-08-22 18:46:57.765-04,15,4,19
6065,45,2011-08-22 18:46:57.765-04,6,13,19
6066,46,2011-08-22 18:46:57.765-04,14,5,19
6067,47,2011-08-22 18:46:57.765-04,11,0,11
6068,48,2011-08-22 18:46:57.765-04,2,13,15
6069,49,2011-08-22 18:46:57.765-04,9,6,15
6070,50,2011-08-22 18:46:57.765-04,3,12,15
6071,51,2011-08-22 18:46:57.765-04,6,9,15
6072,52,2011-08-22 18:46:57.765-04,9,5,14
6073,53,2011-08-22 18:46:57.765-04,10,5,15
6074,55,2011-08-22 18:46:57.765-04,4,11,15
6075,56,2011-08-22 18:46:57.765-04,4,11,15
6076,57,2011-08-22 18:46:57.765-04,7,4,11
6077,3,2011-08-22 18:47:58.818-04,9,8,17
6078,5,2011-08-22 18:47:58.818-04,2,13,15
6079,6,2011-08-22 18:47:58.818-04,12,3,15
6080,8,2011-08-22 18:47:58.818-04,1,14,15
6081,9,2011-08-22 18:47:58.818-04,6,13,19
6082,10,2011-08-22 18:47:58.818-04,5,14,19
6083,11,2011-08-22 18:47:58.818-04,1,14,15
6084,12,2011-08-22 18:47:58.818-04,10,5,15
6085,13,2011-08-22 18:47:58.818-04,7,8,15
6086,14,2011-08-22 18:47:58.818-04,0,17,17
6087,15,2011-08-22 18:47:58.818-04,8,7,15
6088,16,2011-08-22 18:47:58.818-04,13,6,19
6089,17,2011-08-22 18:47:58.818-04,5,10,15
6090,18,2011-08-22 18:47:58.818-04,5,10,15
6091,20,2011-08-22 18:47:58.818-04,7,12,19
6092,21,2011-08-22 18:47:58.818-04,5,18,23
6093,22,2011-08-22 18:47:58.818-04,23,24,47
6094,23,2011-08-22 18:47:58.818-04,5,13,18
6095,24,2011-08-22 18:47:58.818-04,0,15,15
6096,25,2011-08-22 18:47:58.818-04,12,3,15
6097,26,2011-08-22 18:47:58.818-04,7,8,15
6098,27,2011-08-22 18:47:58.818-04,7,7,14
6099,30,2011-08-22 18:47:58.818-04,11,4,15
6100,31,2011-08-22 18:47:58.818-04,5,6,11
6101,32,2011-08-22 18:47:58.818-04,7,4,11
6102,33,2011-08-22 18:47:58.818-04,4,15,19
6103,34,2011-08-22 18:47:58.818-04,8,7,15
6104,35,2011-08-22 18:47:58.818-04,1,10,11
6105,36,2011-08-22 18:47:58.818-04,2,13,15
6106,37,2011-08-22 18:47:58.818-04,8,7,15
6107,38,2011-08-22 18:47:58.818-04,27,8,35
6108,39,2011-08-22 18:47:58.818-04,9,10,19
6109,40,2011-08-22 18:47:58.818-04,12,1,13
6110,41,2011-08-22 18:47:58.818-04,16,3,19
6111,42,2011-08-22 18:47:58.818-04,2,17,19
6112,43,2011-08-22 18:47:58.818-04,3,12,15
6113,44,2011-08-22 18:47:58.818-04,15,4,19
6114,45,2011-08-22 18:47:58.818-04,6,13,19
6115,46,2011-08-22 18:47:58.818-04,14,5,19
6116,47,2011-08-22 18:47:58.818-04,11,0,11
6117,48,2011-08-22 18:47:58.818-04,2,13,15
6118,49,2011-08-22 18:47:58.818-04,9,6,15
6119,50,2011-08-22 18:47:58.818-04,3,12,15
6120,51,2011-08-22 18:47:58.818-04,6,9,15
6121,52,2011-08-22 18:47:58.818-04,9,5,14
6122,53,2011-08-22 18:47:58.818-04,10,5,15
6123,55,2011-08-22 18:47:58.818-04,4,11,15
6124,56,2011-08-22 18:47:58.818-04,4,11,15
6125,57,2011-08-22 18:47:58.818-04,7,4,11
6126,3,2011-08-22 18:48:59.803-04,9,8,17
6127,5,2011-08-22 18:48:59.803-04,2,13,15
6128,6,2011-08-22 18:48:59.803-04,12,3,15
6129,8,2011-08-22 18:48:59.803-04,1,14,15
6130,9,2011-08-22 18:48:59.803-04,6,13,19
6131,10,2011-08-22 18:48:59.803-04,5,14,19
6132,11,2011-08-22 18:48:59.803-04,1,14,15
6133,12,2011-08-22 18:48:59.803-04,10,5,15
6134,13,2011-08-22 18:48:59.803-04,7,8,15
6135,14,2011-08-22 18:48:59.803-04,0,17,17
6136,15,2011-08-22 18:48:59.803-04,8,7,15
6137,16,2011-08-22 18:48:59.803-04,13,6,19
6138,17,2011-08-22 18:48:59.803-04,5,10,15
6139,18,2011-08-22 18:48:59.803-04,5,10,15
6140,20,2011-08-22 18:48:59.803-04,7,12,19
6141,21,2011-08-22 18:48:59.803-04,5,18,23
6142,22,2011-08-22 18:48:59.803-04,23,24,47
6143,23,2011-08-22 18:48:59.803-04,5,13,18
6144,24,2011-08-22 18:48:59.803-04,0,15,15
6145,25,2011-08-22 18:48:59.803-04,12,3,15
6146,26,2011-08-22 18:48:59.803-04,7,8,15
6147,27,2011-08-22 18:48:59.803-04,5,9,14
6148,30,2011-08-22 18:48:59.803-04,11,4,15
6149,31,2011-08-22 18:48:59.803-04,5,6,11
6150,32,2011-08-22 18:48:59.803-04,7,4,11
6151,33,2011-08-22 18:48:59.803-04,4,15,19
6152,34,2011-08-22 18:48:59.803-04,8,7,15
6153,35,2011-08-22 18:48:59.803-04,1,10,11
6154,36,2011-08-22 18:48:59.803-04,2,13,15
6155,37,2011-08-22 18:48:59.803-04,8,7,15
6156,38,2011-08-22 18:48:59.803-04,27,8,35
6157,39,2011-08-22 18:48:59.803-04,9,10,19
6158,40,2011-08-22 18:48:59.803-04,13,0,13
6159,41,2011-08-22 18:48:59.803-04,16,3,19
6160,42,2011-08-22 18:48:59.803-04,1,18,19
6161,43,2011-08-22 18:48:59.803-04,3,12,15
6162,44,2011-08-22 18:48:59.803-04,15,4,19
6163,45,2011-08-22 18:48:59.803-04,7,12,19
6164,46,2011-08-22 18:48:59.803-04,14,5,19
6165,47,2011-08-22 18:48:59.803-04,11,0,11
6166,48,2011-08-22 18:48:59.803-04,2,13,15
6167,49,2011-08-22 18:48:59.803-04,8,7,15
6168,50,2011-08-22 18:48:59.803-04,3,12,15
6169,51,2011-08-22 18:48:59.803-04,6,9,15
6170,52,2011-08-22 18:48:59.803-04,10,4,14
6171,53,2011-08-22 18:48:59.803-04,11,4,15
6172,55,2011-08-22 18:48:59.803-04,4,11,15
6173,56,2011-08-22 18:48:59.803-04,4,11,15
6174,57,2011-08-22 18:48:59.803-04,5,6,11
6175,3,2011-08-22 18:50:00.847-04,9,8,17
6176,5,2011-08-22 18:50:00.847-04,4,11,15
6177,6,2011-08-22 18:50:00.847-04,12,3,15
6178,8,2011-08-22 18:50:00.847-04,1,14,15
6179,9,2011-08-22 18:50:00.847-04,6,13,19
6180,10,2011-08-22 18:50:00.847-04,5,14,19
6181,11,2011-08-22 18:50:00.847-04,1,14,15
6182,12,2011-08-22 18:50:00.847-04,10,5,15
6183,13,2011-08-22 18:50:00.847-04,7,8,15
6184,14,2011-08-22 18:50:00.847-04,0,17,17
6185,15,2011-08-22 18:50:00.847-04,8,7,15
6186,16,2011-08-22 18:50:00.847-04,13,6,19
6187,17,2011-08-22 18:50:00.847-04,5,10,15
6188,18,2011-08-22 18:50:00.847-04,5,10,15
6189,20,2011-08-22 18:50:00.847-04,8,11,19
6190,21,2011-08-22 18:50:00.847-04,5,18,23
6191,22,2011-08-22 18:50:00.847-04,23,24,47
6192,23,2011-08-22 18:50:00.847-04,5,13,18
6193,24,2011-08-22 18:50:00.847-04,0,15,15
6194,25,2011-08-22 18:50:00.847-04,12,3,15
6195,26,2011-08-22 18:50:00.847-04,7,8,15
6196,27,2011-08-22 18:50:00.847-04,5,9,14
6197,30,2011-08-22 18:50:00.847-04,11,4,15
6198,31,2011-08-22 18:50:00.847-04,5,6,11
6199,32,2011-08-22 18:50:00.847-04,7,4,11
6200,33,2011-08-22 18:50:00.847-04,4,15,19
6201,34,2011-08-22 18:50:00.847-04,8,7,15
6202,35,2011-08-22 18:50:00.847-04,1,10,11
6203,36,2011-08-22 18:50:00.847-04,2,13,15
6204,37,2011-08-22 18:50:00.847-04,8,7,15
6205,38,2011-08-22 18:50:00.847-04,27,8,35
6206,39,2011-08-22 18:50:00.847-04,9,10,19
6207,40,2011-08-22 18:50:00.847-04,12,1,13
6208,41,2011-08-22 18:50:00.847-04,16,3,19
6209,42,2011-08-22 18:50:00.847-04,1,18,19
6210,43,2011-08-22 18:50:00.847-04,3,12,15
6211,44,2011-08-22 18:50:00.847-04,15,4,19
6212,45,2011-08-22 18:50:00.847-04,7,12,19
6213,46,2011-08-22 18:50:00.847-04,14,5,19
6214,47,2011-08-22 18:50:00.847-04,11,0,11
6215,48,2011-08-22 18:50:00.847-04,2,13,15
6216,49,2011-08-22 18:50:00.847-04,7,8,15
6217,50,2011-08-22 18:50:00.847-04,3,12,15
6218,51,2011-08-22 18:50:00.847-04,6,9,15
6219,52,2011-08-22 18:50:00.847-04,10,4,14
6220,53,2011-08-22 18:50:00.847-04,10,5,15
6221,55,2011-08-22 18:50:00.847-04,4,11,15
6222,56,2011-08-22 18:50:00.847-04,4,11,15
6223,57,2011-08-22 18:50:00.847-04,5,6,11
6224,3,2011-08-22 18:51:01.724-04,9,8,17
6225,5,2011-08-22 18:51:01.724-04,5,10,15
6226,6,2011-08-22 18:51:01.724-04,12,3,15
6227,8,2011-08-22 18:51:01.724-04,1,14,15
6228,9,2011-08-22 18:51:01.724-04,6,13,19
6229,10,2011-08-22 18:51:01.724-04,5,14,19
6230,11,2011-08-22 18:51:01.724-04,1,14,15
6231,12,2011-08-22 18:51:01.724-04,10,5,15
6232,13,2011-08-22 18:51:01.724-04,7,8,15
6233,14,2011-08-22 18:51:01.724-04,0,17,17
6234,15,2011-08-22 18:51:01.724-04,8,7,15
6235,16,2011-08-22 18:51:01.724-04,13,6,19
6236,17,2011-08-22 18:51:01.724-04,5,10,15
6237,18,2011-08-22 18:51:01.724-04,5,10,15
6238,20,2011-08-22 18:51:01.724-04,11,8,19
6239,21,2011-08-22 18:51:01.724-04,5,18,23
6240,22,2011-08-22 18:51:01.724-04,23,24,47
6241,23,2011-08-22 18:51:01.724-04,5,13,18
6242,24,2011-08-22 18:51:01.724-04,0,15,15
6243,25,2011-08-22 18:51:01.724-04,12,3,15
6244,26,2011-08-22 18:51:01.724-04,7,8,15
6245,27,2011-08-22 18:51:01.724-04,5,9,14
6246,30,2011-08-22 18:51:01.724-04,11,4,15
6247,31,2011-08-22 18:51:01.724-04,5,6,11
6248,32,2011-08-22 18:51:01.724-04,7,4,11
6249,33,2011-08-22 18:51:01.724-04,4,15,19
6250,34,2011-08-22 18:51:01.724-04,8,7,15
6251,35,2011-08-22 18:51:01.724-04,1,10,11
6252,36,2011-08-22 18:51:01.724-04,2,13,15
6253,37,2011-08-22 18:51:01.724-04,8,7,15
6254,38,2011-08-22 18:51:01.724-04,27,8,35
6255,39,2011-08-22 18:51:01.724-04,9,10,19
6256,40,2011-08-22 18:51:01.724-04,12,1,13
6257,41,2011-08-22 18:51:01.724-04,16,3,19
6258,42,2011-08-22 18:51:01.724-04,1,18,19
6259,43,2011-08-22 18:51:01.724-04,3,12,15
6260,44,2011-08-22 18:51:01.724-04,15,4,19
6261,45,2011-08-22 18:51:01.724-04,7,12,19
6262,46,2011-08-22 18:51:01.724-04,14,5,19
6263,47,2011-08-22 18:51:01.724-04,11,0,11
6264,48,2011-08-22 18:51:01.724-04,2,13,15
6265,49,2011-08-22 18:51:01.724-04,7,8,15
6266,50,2011-08-22 18:51:01.724-04,3,12,15
6267,51,2011-08-22 18:51:01.724-04,6,9,15
6268,52,2011-08-22 18:51:01.724-04,10,4,14
6269,53,2011-08-22 18:51:01.724-04,10,5,15
6270,55,2011-08-22 18:51:01.724-04,4,11,15
6271,56,2011-08-22 18:51:01.724-04,4,11,15
6272,57,2011-08-22 18:51:01.724-04,4,7,11
6273,3,2011-08-22 18:52:02.695-04,9,8,17
6274,5,2011-08-22 18:52:02.695-04,6,9,15
6275,6,2011-08-22 18:52:02.695-04,12,3,15
6276,8,2011-08-22 18:52:02.695-04,1,14,15
6277,9,2011-08-22 18:52:02.695-04,6,13,19
6278,10,2011-08-22 18:52:02.695-04,5,14,19
6279,11,2011-08-22 18:52:02.695-04,1,14,15
6280,12,2011-08-22 18:52:02.695-04,10,5,15
6281,13,2011-08-22 18:52:02.695-04,7,8,15
6282,14,2011-08-22 18:52:02.695-04,0,17,17
6283,15,2011-08-22 18:52:02.695-04,8,7,15
6284,16,2011-08-22 18:52:02.695-04,14,5,19
6285,17,2011-08-22 18:52:02.695-04,5,10,15
6286,18,2011-08-22 18:52:02.695-04,5,10,15
6287,20,2011-08-22 18:52:02.695-04,11,8,19
6288,21,2011-08-22 18:52:02.695-04,5,18,23
6289,22,2011-08-22 18:52:02.695-04,23,24,47
6290,23,2011-08-22 18:52:02.695-04,5,13,18
6291,24,2011-08-22 18:52:02.695-04,0,15,15
6292,25,2011-08-22 18:52:02.695-04,12,3,15
6293,26,2011-08-22 18:52:02.695-04,7,8,15
6294,27,2011-08-22 18:52:02.695-04,5,9,14
6295,30,2011-08-22 18:52:02.695-04,11,4,15
6296,31,2011-08-22 18:52:02.695-04,5,6,11
6297,32,2011-08-22 18:52:02.695-04,7,4,11
6298,33,2011-08-22 18:52:02.695-04,4,15,19
6299,34,2011-08-22 18:52:02.695-04,8,7,15
6300,35,2011-08-22 18:52:02.695-04,1,10,11
6301,36,2011-08-22 18:52:02.695-04,2,13,15
6302,37,2011-08-22 18:52:02.695-04,8,7,15
6303,38,2011-08-22 18:52:02.695-04,27,8,35
6304,39,2011-08-22 18:52:02.695-04,10,9,19
6305,40,2011-08-22 18:52:02.695-04,12,1,13
6306,41,2011-08-22 18:52:02.695-04,15,4,19
6307,42,2011-08-22 18:52:02.695-04,1,18,19
6308,43,2011-08-22 18:52:02.695-04,3,12,15
6309,44,2011-08-22 18:52:02.695-04,15,4,19
6310,45,2011-08-22 18:52:02.695-04,7,12,19
6311,46,2011-08-22 18:52:02.695-04,14,5,19
6312,47,2011-08-22 18:52:02.695-04,11,0,11
6313,48,2011-08-22 18:52:02.695-04,2,13,15
6314,49,2011-08-22 18:52:02.695-04,7,8,15
6315,50,2011-08-22 18:52:02.695-04,3,12,15
6316,51,2011-08-22 18:52:02.695-04,6,9,15
6317,52,2011-08-22 18:52:02.695-04,10,4,14
6318,53,2011-08-22 18:52:02.695-04,10,5,15
6319,55,2011-08-22 18:52:02.695-04,4,11,15
6320,56,2011-08-22 18:52:02.695-04,4,11,15
6321,57,2011-08-22 18:52:02.695-04,4,7,11
6322,3,2011-08-22 18:53:03.625-04,9,8,17
6323,5,2011-08-22 18:53:03.625-04,6,9,15
6324,6,2011-08-22 18:53:03.625-04,12,3,15
6325,8,2011-08-22 18:53:03.625-04,1,14,15
6326,9,2011-08-22 18:53:03.625-04,6,13,19
6327,10,2011-08-22 18:53:03.625-04,5,14,19
6328,11,2011-08-22 18:53:03.625-04,1,14,15
6329,12,2011-08-22 18:53:03.625-04,10,5,15
6330,13,2011-08-22 18:53:03.625-04,6,9,15
6331,14,2011-08-22 18:53:03.625-04,0,17,17
6332,15,2011-08-22 18:53:03.625-04,8,7,15
6333,16,2011-08-22 18:53:03.625-04,14,5,19
6334,17,2011-08-22 18:53:03.625-04,5,10,15
6335,18,2011-08-22 18:53:03.625-04,5,10,15
6336,20,2011-08-22 18:53:03.625-04,11,8,19
6337,21,2011-08-22 18:53:03.625-04,5,18,23
6338,22,2011-08-22 18:53:03.625-04,23,24,47
6339,23,2011-08-22 18:53:03.625-04,5,13,18
6340,24,2011-08-22 18:53:03.625-04,0,15,15
6341,25,2011-08-22 18:53:03.625-04,12,3,15
6342,26,2011-08-22 18:53:03.625-04,7,8,15
6343,27,2011-08-22 18:53:03.625-04,5,9,14
6344,30,2011-08-22 18:53:03.625-04,11,4,15
6345,31,2011-08-22 18:53:03.625-04,5,6,11
6346,32,2011-08-22 18:53:03.625-04,7,4,11
6347,33,2011-08-22 18:53:03.625-04,4,15,19
6348,34,2011-08-22 18:53:03.625-04,8,7,15
6349,35,2011-08-22 18:53:03.625-04,1,10,11
6350,36,2011-08-22 18:53:03.625-04,2,13,15
6351,37,2011-08-22 18:53:03.625-04,8,7,15
6352,38,2011-08-22 18:53:03.625-04,27,8,35
6353,39,2011-08-22 18:53:03.625-04,10,9,19
6354,40,2011-08-22 18:53:03.625-04,12,1,13
6355,41,2011-08-22 18:53:03.625-04,15,4,19
6356,42,2011-08-22 18:53:03.625-04,1,18,19
6357,43,2011-08-22 18:53:03.625-04,3,12,15
6358,44,2011-08-22 18:53:03.625-04,15,4,19
6359,45,2011-08-22 18:53:03.625-04,7,12,19
6360,46,2011-08-22 18:53:03.625-04,14,5,19
6361,47,2011-08-22 18:53:03.625-04,11,0,11
6362,48,2011-08-22 18:53:03.625-04,2,13,15
6363,49,2011-08-22 18:53:03.625-04,9,6,15
6364,50,2011-08-22 18:53:03.625-04,3,12,15
6365,51,2011-08-22 18:53:03.625-04,6,9,15
6366,52,2011-08-22 18:53:03.625-04,9,5,14
6367,53,2011-08-22 18:53:03.625-04,10,5,15
6368,55,2011-08-22 18:53:03.625-04,4,11,15
6369,56,2011-08-22 18:53:03.625-04,4,11,15
6370,57,2011-08-22 18:53:03.625-04,4,7,11
6371,3,2011-08-22 18:54:04.614-04,9,8,17
6372,5,2011-08-22 18:54:04.614-04,6,9,15
6373,6,2011-08-22 18:54:04.614-04,12,3,15
6374,8,2011-08-22 18:54:04.614-04,1,14,15
6375,9,2011-08-22 18:54:04.614-04,6,13,19
6376,10,2011-08-22 18:54:04.614-04,5,14,19
6377,11,2011-08-22 18:54:04.614-04,1,14,15
6378,12,2011-08-22 18:54:04.614-04,10,5,15
6379,13,2011-08-22 18:54:04.614-04,6,9,15
6380,14,2011-08-22 18:54:04.614-04,0,17,17
6381,15,2011-08-22 18:54:04.614-04,8,7,15
6382,16,2011-08-22 18:54:04.614-04,14,5,19
6383,17,2011-08-22 18:54:04.614-04,5,10,15
6384,18,2011-08-22 18:54:04.614-04,5,10,15
6385,20,2011-08-22 18:54:04.614-04,11,8,19
6386,21,2011-08-22 18:54:04.614-04,5,18,23
6387,22,2011-08-22 18:54:04.614-04,23,24,47
6388,23,2011-08-22 18:54:04.614-04,4,14,18
6389,24,2011-08-22 18:54:04.614-04,0,15,15
6390,25,2011-08-22 18:54:04.614-04,12,3,15
6391,26,2011-08-22 18:54:04.614-04,7,8,15
6392,27,2011-08-22 18:54:04.614-04,5,9,14
6393,30,2011-08-22 18:54:04.614-04,11,4,15
6394,31,2011-08-22 18:54:04.614-04,5,6,11
6395,32,2011-08-22 18:54:04.614-04,7,4,11
6396,33,2011-08-22 18:54:04.614-04,4,15,19
6397,34,2011-08-22 18:54:04.614-04,8,7,15
6398,35,2011-08-22 18:54:04.614-04,1,10,11
6399,36,2011-08-22 18:54:04.614-04,0,15,15
6400,37,2011-08-22 18:54:04.614-04,8,7,15
6401,38,2011-08-22 18:54:04.614-04,27,8,35
6402,39,2011-08-22 18:54:04.614-04,10,9,19
6403,40,2011-08-22 18:54:04.614-04,12,1,13
6404,41,2011-08-22 18:54:04.614-04,15,4,19
6405,42,2011-08-22 18:54:04.614-04,1,18,19
6406,43,2011-08-22 18:54:04.614-04,3,12,15
6407,44,2011-08-22 18:54:04.614-04,15,4,19
6408,45,2011-08-22 18:54:04.614-04,7,12,19
6409,46,2011-08-22 18:54:04.614-04,14,5,19
6410,47,2011-08-22 18:54:04.614-04,11,0,11
6411,48,2011-08-22 18:54:04.614-04,2,13,15
6412,49,2011-08-22 18:54:04.614-04,9,6,15
6413,50,2011-08-22 18:54:04.614-04,3,12,15
6414,51,2011-08-22 18:54:04.614-04,6,9,15
6415,52,2011-08-22 18:54:04.614-04,7,7,14
6416,53,2011-08-22 18:54:04.614-04,10,5,15
6417,55,2011-08-22 18:54:04.614-04,4,11,15
6418,56,2011-08-22 18:54:04.614-04,4,11,15
6419,57,2011-08-22 18:54:04.614-04,4,7,11
6420,3,2011-08-22 18:55:05.468-04,9,8,17
6421,5,2011-08-22 18:55:05.468-04,6,9,15
6422,6,2011-08-22 18:55:05.468-04,12,3,15
6423,8,2011-08-22 18:55:05.468-04,1,14,15
6424,9,2011-08-22 18:55:05.468-04,6,13,19
6425,10,2011-08-22 18:55:05.468-04,4,15,19
6426,11,2011-08-22 18:55:05.468-04,1,14,15
6427,12,2011-08-22 18:55:05.468-04,10,5,15
6428,13,2011-08-22 18:55:05.468-04,7,8,15
6429,14,2011-08-22 18:55:05.468-04,0,17,17
6430,15,2011-08-22 18:55:05.468-04,8,7,15
6431,16,2011-08-22 18:55:05.468-04,14,5,19
6432,17,2011-08-22 18:55:05.468-04,5,10,15
6433,18,2011-08-22 18:55:05.468-04,7,8,15
6434,20,2011-08-22 18:55:05.468-04,11,8,19
6435,21,2011-08-22 18:55:05.468-04,5,18,23
6436,22,2011-08-22 18:55:05.468-04,23,24,47
6437,23,2011-08-22 18:55:05.468-04,4,14,18
6438,24,2011-08-22 18:55:05.468-04,0,15,15
6439,25,2011-08-22 18:55:05.468-04,12,3,15
6440,26,2011-08-22 18:55:05.468-04,7,8,15
6441,27,2011-08-22 18:55:05.468-04,5,9,14
6442,30,2011-08-22 18:55:05.468-04,11,4,15
6443,31,2011-08-22 18:55:05.468-04,5,6,11
6444,32,2011-08-22 18:55:05.468-04,7,4,11
6445,33,2011-08-22 18:55:05.468-04,4,15,19
6446,34,2011-08-22 18:55:05.468-04,8,7,15
6447,35,2011-08-22 18:55:05.468-04,1,10,11
6448,36,2011-08-22 18:55:05.468-04,0,15,15
6449,37,2011-08-22 18:55:05.468-04,8,7,15
6450,38,2011-08-22 18:55:05.468-04,27,8,35
6451,39,2011-08-22 18:55:05.468-04,9,10,19
6452,40,2011-08-22 18:55:05.468-04,12,1,13
6453,41,2011-08-22 18:55:05.468-04,15,4,19
6454,42,2011-08-22 18:55:05.468-04,1,18,19
6455,43,2011-08-22 18:55:05.468-04,3,12,15
6456,44,2011-08-22 18:55:05.468-04,15,4,19
6457,45,2011-08-22 18:55:05.468-04,7,12,19
6458,46,2011-08-22 18:55:05.468-04,13,6,19
6459,47,2011-08-22 18:55:05.468-04,11,0,11
6460,48,2011-08-22 18:55:05.468-04,2,13,15
6461,49,2011-08-22 18:55:05.468-04,9,6,15
6462,50,2011-08-22 18:55:05.468-04,3,12,15
6463,51,2011-08-22 18:55:05.468-04,6,9,15
6464,52,2011-08-22 18:55:05.468-04,7,7,14
6465,53,2011-08-22 18:55:05.468-04,10,5,15
6466,55,2011-08-22 18:55:05.468-04,4,11,15
6467,56,2011-08-22 18:55:05.468-04,4,11,15
6468,57,2011-08-22 18:55:05.468-04,4,7,11
6469,3,2011-08-22 18:56:06.686-04,9,8,17
6470,5,2011-08-22 18:56:06.686-04,6,9,15
6471,6,2011-08-22 18:56:06.686-04,12,3,15
6472,8,2011-08-22 18:56:06.686-04,1,14,15
6473,9,2011-08-22 18:56:06.686-04,6,13,19
6474,10,2011-08-22 18:56:06.686-04,4,15,19
6475,11,2011-08-22 18:56:06.686-04,1,14,15
6476,12,2011-08-22 18:56:06.686-04,10,5,15
6477,13,2011-08-22 18:56:06.686-04,7,8,15
6478,14,2011-08-22 18:56:06.686-04,0,17,17
6479,15,2011-08-22 18:56:06.686-04,8,7,15
6480,16,2011-08-22 18:56:06.686-04,14,5,19
6481,17,2011-08-22 18:56:06.686-04,5,10,15
6482,18,2011-08-22 18:56:06.686-04,7,8,15
6483,20,2011-08-22 18:56:06.686-04,11,8,19
6484,21,2011-08-22 18:56:06.686-04,5,18,23
6485,22,2011-08-22 18:56:06.686-04,23,24,47
6486,23,2011-08-22 18:56:06.686-04,4,14,18
6487,24,2011-08-22 18:56:06.686-04,0,15,15
6488,25,2011-08-22 18:56:06.686-04,10,5,15
6489,26,2011-08-22 18:56:06.686-04,7,8,15
6490,27,2011-08-22 18:56:06.686-04,5,9,14
6491,30,2011-08-22 18:56:06.686-04,11,4,15
6492,31,2011-08-22 18:56:06.686-04,5,6,11
6493,32,2011-08-22 18:56:06.686-04,7,4,11
6494,33,2011-08-22 18:56:06.686-04,4,15,19
6495,34,2011-08-22 18:56:06.686-04,8,7,15
6496,35,2011-08-22 18:56:06.686-04,1,10,11
6497,36,2011-08-22 18:56:06.686-04,0,15,15
6498,37,2011-08-22 18:56:06.686-04,8,7,15
6499,38,2011-08-22 18:56:06.686-04,27,8,35
6500,39,2011-08-22 18:56:06.686-04,9,10,19
6501,40,2011-08-22 18:56:06.686-04,12,1,13
6502,41,2011-08-22 18:56:06.686-04,15,4,19
6503,42,2011-08-22 18:56:06.686-04,1,18,19
6504,43,2011-08-22 18:56:06.686-04,3,12,15
6505,44,2011-08-22 18:56:06.686-04,15,4,19
6506,45,2011-08-22 18:56:06.686-04,7,12,19
6507,46,2011-08-22 18:56:06.686-04,13,6,19
6508,47,2011-08-22 18:56:06.686-04,11,0,11
6509,48,2011-08-22 18:56:06.686-04,2,13,15
6510,49,2011-08-22 18:56:06.686-04,9,6,15
6511,50,2011-08-22 18:56:06.686-04,3,12,15
6512,51,2011-08-22 18:56:06.686-04,6,9,15
6513,52,2011-08-22 18:56:06.686-04,7,7,14
6514,53,2011-08-22 18:56:06.686-04,10,5,15
6515,55,2011-08-22 18:56:06.686-04,4,11,15
6516,56,2011-08-22 18:56:06.686-04,4,11,15
6517,57,2011-08-22 18:56:06.686-04,4,7,11
6518,3,2011-08-22 18:57:07.667-04,9,8,17
6519,5,2011-08-22 18:57:07.667-04,6,9,15
6520,6,2011-08-22 18:57:07.667-04,12,3,15
6521,8,2011-08-22 18:57:07.667-04,2,13,15
6522,9,2011-08-22 18:57:07.667-04,6,13,19
6523,10,2011-08-22 18:57:07.667-04,4,15,19
6524,11,2011-08-22 18:57:07.667-04,1,14,15
6525,12,2011-08-22 18:57:07.667-04,10,5,15
6526,13,2011-08-22 18:57:07.667-04,7,8,15
6527,14,2011-08-22 18:57:07.667-04,0,17,17
6528,15,2011-08-22 18:57:07.667-04,8,7,15
6529,16,2011-08-22 18:57:07.667-04,14,5,19
6530,17,2011-08-22 18:57:07.667-04,5,10,15
6531,18,2011-08-22 18:57:07.667-04,7,8,15
6532,20,2011-08-22 18:57:07.667-04,11,8,19
6533,21,2011-08-22 18:57:07.667-04,5,18,23
6534,22,2011-08-22 18:57:07.667-04,23,24,47
6535,23,2011-08-22 18:57:07.667-04,4,14,18
6536,24,2011-08-22 18:57:07.667-04,0,15,15
6537,25,2011-08-22 18:57:07.667-04,10,5,15
6538,26,2011-08-22 18:57:07.667-04,7,8,15
6539,27,2011-08-22 18:57:07.667-04,5,9,14
6540,30,2011-08-22 18:57:07.667-04,11,4,15
6541,31,2011-08-22 18:57:07.667-04,5,6,11
6542,32,2011-08-22 18:57:07.667-04,7,4,11
6543,33,2011-08-22 18:57:07.667-04,4,15,19
6544,34,2011-08-22 18:57:07.667-04,8,7,15
6545,35,2011-08-22 18:57:07.667-04,1,10,11
6546,36,2011-08-22 18:57:07.667-04,0,15,15
6547,37,2011-08-22 18:57:07.667-04,8,7,15
6548,38,2011-08-22 18:57:07.667-04,27,8,35
6549,39,2011-08-22 18:57:07.667-04,9,10,19
6550,40,2011-08-22 18:57:07.667-04,12,1,13
6551,41,2011-08-22 18:57:07.667-04,15,4,19
6552,42,2011-08-22 18:57:07.667-04,1,18,19
6553,43,2011-08-22 18:57:07.667-04,3,12,15
6554,44,2011-08-22 18:57:07.667-04,15,4,19
6555,45,2011-08-22 18:57:07.667-04,7,12,19
6556,46,2011-08-22 18:57:07.667-04,13,6,19
6557,47,2011-08-22 18:57:07.667-04,11,0,11
6558,48,2011-08-22 18:57:07.667-04,2,13,15
6559,49,2011-08-22 18:57:07.667-04,9,6,15
6560,50,2011-08-22 18:57:07.667-04,3,12,15
6561,51,2011-08-22 18:57:07.667-04,6,9,15
6562,52,2011-08-22 18:57:07.667-04,7,7,14
6563,53,2011-08-22 18:57:07.667-04,10,5,15
6564,55,2011-08-22 18:57:07.667-04,4,11,15
6565,56,2011-08-22 18:57:07.667-04,4,11,15
6566,57,2011-08-22 18:57:07.667-04,4,7,11
6567,3,2011-08-22 18:57:07.667-04,9,8,17
6568,5,2011-08-22 18:57:07.667-04,6,9,15
6569,6,2011-08-22 18:57:07.667-04,12,3,15
6570,8,2011-08-22 18:57:07.667-04,2,13,15
6571,9,2011-08-22 18:57:07.667-04,6,13,19
6572,10,2011-08-22 18:57:07.667-04,4,15,19
6573,11,2011-08-22 18:57:07.667-04,1,14,15
6574,12,2011-08-22 18:57:07.667-04,10,5,15
6575,13,2011-08-22 18:57:07.667-04,7,8,15
6576,14,2011-08-22 18:57:07.667-04,0,17,17
6577,15,2011-08-22 18:57:07.667-04,8,7,15
6578,16,2011-08-22 18:57:07.667-04,14,5,19
6579,17,2011-08-22 18:57:07.667-04,5,10,15
6580,18,2011-08-22 18:57:07.667-04,7,8,15
6581,20,2011-08-22 18:57:07.667-04,11,8,19
6582,21,2011-08-22 18:57:07.667-04,5,18,23
6583,22,2011-08-22 18:57:07.667-04,23,24,47
6584,23,2011-08-22 18:57:07.667-04,4,14,18
6585,24,2011-08-22 18:57:07.667-04,0,15,15
6586,25,2011-08-22 18:57:07.667-04,10,5,15
6587,26,2011-08-22 18:57:07.667-04,7,8,15
6588,27,2011-08-22 18:57:07.667-04,5,9,14
6589,30,2011-08-22 18:57:07.667-04,11,4,15
6590,31,2011-08-22 18:57:07.667-04,5,6,11
6591,32,2011-08-22 18:57:07.667-04,7,4,11
6592,33,2011-08-22 18:57:07.667-04,4,15,19
6593,34,2011-08-22 18:57:07.667-04,8,7,15
6594,35,2011-08-22 18:57:07.667-04,1,10,11
6595,36,2011-08-22 18:57:07.667-04,0,15,15
6596,37,2011-08-22 18:57:07.667-04,8,7,15
6597,38,2011-08-22 18:57:07.667-04,27,8,35
6598,39,2011-08-22 18:57:07.667-04,9,10,19
6599,40,2011-08-22 18:57:07.667-04,12,1,13
6600,41,2011-08-22 18:57:07.667-04,15,4,19
6601,42,2011-08-22 18:57:07.667-04,1,18,19
6602,43,2011-08-22 18:57:07.667-04,3,12,15
6603,44,2011-08-22 18:57:07.667-04,15,4,19
6604,45,2011-08-22 18:57:07.667-04,7,12,19
6605,46,2011-08-22 18:57:07.667-04,13,6,19
6606,47,2011-08-22 18:57:07.667-04,11,0,11
6607,48,2011-08-22 18:57:07.667-04,2,13,15
6608,49,2011-08-22 18:57:07.667-04,9,6,15
6609,50,2011-08-22 18:57:07.667-04,3,12,15
6610,51,2011-08-22 18:57:07.667-04,6,9,15
6611,52,2011-08-22 18:57:07.667-04,7,7,14
6612,53,2011-08-22 18:57:07.667-04,10,5,15
6613,55,2011-08-22 18:57:07.667-04,4,11,15
6614,56,2011-08-22 18:57:07.667-04,4,11,15
6615,57,2011-08-22 18:57:07.667-04,4,7,11
6616,3,2011-08-22 18:58:08.556-04,9,8,17
6617,5,2011-08-22 18:58:08.556-04,6,9,15
6618,6,2011-08-22 18:58:08.556-04,12,3,15
6619,8,2011-08-22 18:58:08.556-04,2,13,15
6620,9,2011-08-22 18:58:08.556-04,6,13,19
6621,10,2011-08-22 18:58:08.556-04,4,15,19
6622,11,2011-08-22 18:58:08.556-04,1,14,15
6623,12,2011-08-22 18:58:08.556-04,10,5,15
6624,13,2011-08-22 18:58:08.556-04,7,8,15
6625,14,2011-08-22 18:58:08.556-04,0,17,17
6626,15,2011-08-22 18:58:08.556-04,8,7,15
6627,16,2011-08-22 18:58:08.556-04,14,5,19
6628,17,2011-08-22 18:58:08.556-04,5,10,15
6629,18,2011-08-22 18:58:08.556-04,7,8,15
6630,20,2011-08-22 18:58:08.556-04,11,8,19
6631,21,2011-08-22 18:58:08.556-04,5,18,23
6632,22,2011-08-22 18:58:08.556-04,23,24,47
6633,23,2011-08-22 18:58:08.556-04,4,14,18
6634,24,2011-08-22 18:58:08.556-04,1,14,15
6635,25,2011-08-22 18:58:08.556-04,8,7,15
6636,26,2011-08-22 18:58:08.556-04,7,8,15
6637,27,2011-08-22 18:58:08.556-04,5,9,14
6638,30,2011-08-22 18:58:08.556-04,11,4,15
6639,31,2011-08-22 18:58:08.556-04,5,6,11
6640,32,2011-08-22 18:58:08.556-04,7,4,11
6641,33,2011-08-22 18:58:08.556-04,4,15,19
6642,34,2011-08-22 18:58:08.556-04,8,7,15
6643,35,2011-08-22 18:58:08.556-04,0,11,11
6644,36,2011-08-22 18:58:08.556-04,0,15,15
6645,37,2011-08-22 18:58:08.556-04,8,7,15
6646,38,2011-08-22 18:58:08.556-04,27,8,35
6647,39,2011-08-22 18:58:08.556-04,9,10,19
6648,40,2011-08-22 18:58:08.556-04,12,1,13
6649,41,2011-08-22 18:58:08.556-04,15,4,19
6650,42,2011-08-22 18:58:08.556-04,1,18,19
6651,43,2011-08-22 18:58:08.556-04,3,12,15
6652,44,2011-08-22 18:58:08.556-04,15,4,19
6653,45,2011-08-22 18:58:08.556-04,7,12,19
6654,46,2011-08-22 18:58:08.556-04,14,5,19
6655,47,2011-08-22 18:58:08.556-04,11,0,11
6656,48,2011-08-22 18:58:08.556-04,2,13,15
6657,49,2011-08-22 18:58:08.556-04,9,6,15
6658,50,2011-08-22 18:58:08.556-04,3,12,15
6659,51,2011-08-22 18:58:08.556-04,6,9,15
6660,52,2011-08-22 18:58:08.556-04,7,7,14
6661,53,2011-08-22 18:58:08.556-04,10,5,15
6662,55,2011-08-22 18:58:08.556-04,4,11,15
6663,56,2011-08-22 18:58:08.556-04,4,11,15
6664,57,2011-08-22 18:58:08.556-04,4,7,11
6665,3,2011-08-22 18:59:09.511-04,9,8,17
6666,5,2011-08-22 18:59:09.511-04,6,9,15
6667,6,2011-08-22 18:59:09.511-04,12,3,15
6668,8,2011-08-22 18:59:09.511-04,2,13,15
6669,9,2011-08-22 18:59:09.511-04,6,13,19
6670,10,2011-08-22 18:59:09.511-04,4,15,19
6671,11,2011-08-22 18:59:09.511-04,1,14,15
6672,12,2011-08-22 18:59:09.511-04,10,5,15
6673,13,2011-08-22 18:59:09.511-04,7,8,15
6674,14,2011-08-22 18:59:09.511-04,0,17,17
6675,15,2011-08-22 18:59:09.511-04,8,7,15
6676,16,2011-08-22 18:59:09.511-04,12,7,19
6677,17,2011-08-22 18:59:09.511-04,5,10,15
6678,18,2011-08-22 18:59:09.511-04,7,8,15
6679,20,2011-08-22 18:59:09.511-04,11,8,19
6680,21,2011-08-22 18:59:09.511-04,5,18,23
6681,22,2011-08-22 18:59:09.511-04,23,24,47
6682,23,2011-08-22 18:59:09.511-04,4,14,18
6683,24,2011-08-22 18:59:09.511-04,1,14,15
6684,25,2011-08-22 18:59:09.511-04,8,7,15
6685,26,2011-08-22 18:59:09.511-04,7,8,15
6686,27,2011-08-22 18:59:09.511-04,5,9,14
6687,30,2011-08-22 18:59:09.511-04,11,4,15
6688,31,2011-08-22 18:59:09.511-04,5,6,11
6689,32,2011-08-22 18:59:09.511-04,7,4,11
6690,33,2011-08-22 18:59:09.511-04,6,13,19
6691,34,2011-08-22 18:59:09.511-04,8,7,15
6692,35,2011-08-22 18:59:09.511-04,0,11,11
6693,36,2011-08-22 18:59:09.511-04,0,15,15
6694,37,2011-08-22 18:59:09.511-04,8,7,15
6695,38,2011-08-22 18:59:09.511-04,27,8,35
6696,39,2011-08-22 18:59:09.511-04,9,10,19
6697,40,2011-08-22 18:59:09.511-04,12,1,13
6698,41,2011-08-22 18:59:09.511-04,16,3,19
6699,42,2011-08-22 18:59:09.511-04,2,17,19
6700,43,2011-08-22 18:59:09.511-04,2,13,15
6701,44,2011-08-22 18:59:09.511-04,15,4,19
6702,45,2011-08-22 18:59:09.511-04,7,12,19
6703,46,2011-08-22 18:59:09.511-04,14,5,19
6704,47,2011-08-22 18:59:09.511-04,11,0,11
6705,48,2011-08-22 18:59:09.511-04,2,13,15
6706,49,2011-08-22 18:59:09.511-04,9,6,15
6707,50,2011-08-22 18:59:09.511-04,3,12,15
6708,51,2011-08-22 18:59:09.511-04,6,9,15
6709,52,2011-08-22 18:59:09.511-04,7,7,14
6710,53,2011-08-22 18:59:09.511-04,10,5,15
6711,55,2011-08-22 18:59:09.511-04,4,11,15
6712,56,2011-08-22 18:59:09.511-04,4,11,15
6713,57,2011-08-22 18:59:09.511-04,4,7,11
6714,3,2011-08-22 19:00:10.438-04,9,8,17
6715,5,2011-08-22 19:00:10.438-04,6,9,15
6716,6,2011-08-22 19:00:10.438-04,12,3,15
6717,8,2011-08-22 19:00:10.438-04,2,13,15
6718,9,2011-08-22 19:00:10.438-04,6,13,19
6719,10,2011-08-22 19:00:10.438-04,4,15,19
6720,11,2011-08-22 19:00:10.438-04,1,14,15
6721,12,2011-08-22 19:00:10.438-04,10,5,15
6722,13,2011-08-22 19:00:10.438-04,7,8,15
6723,14,2011-08-22 19:00:10.438-04,0,17,17
6724,15,2011-08-22 19:00:10.438-04,8,7,15
6725,16,2011-08-22 19:00:10.438-04,12,7,19
6726,17,2011-08-22 19:00:10.438-04,5,10,15
6727,18,2011-08-22 19:00:10.438-04,7,8,15
6728,20,2011-08-22 19:00:10.438-04,11,8,19
6729,21,2011-08-22 19:00:10.438-04,5,18,23
6730,22,2011-08-22 19:00:10.438-04,22,25,47
6731,23,2011-08-22 19:00:10.438-04,4,14,18
6732,24,2011-08-22 19:00:10.438-04,1,14,15
6733,25,2011-08-22 19:00:10.438-04,7,8,15
6734,26,2011-08-22 19:00:10.438-04,7,8,15
6735,27,2011-08-22 19:00:10.438-04,5,9,14
6736,30,2011-08-22 19:00:10.438-04,11,4,15
6737,31,2011-08-22 19:00:10.438-04,5,6,11
6738,32,2011-08-22 19:00:10.438-04,7,4,11
6739,33,2011-08-22 19:00:10.438-04,6,13,19
6740,34,2011-08-22 19:00:10.438-04,8,7,15
6741,35,2011-08-22 19:00:10.438-04,0,11,11
6742,36,2011-08-22 19:00:10.438-04,0,15,15
6743,37,2011-08-22 19:00:10.438-04,8,7,15
6744,38,2011-08-22 19:00:10.438-04,27,8,35
6745,39,2011-08-22 19:00:10.438-04,9,10,19
6746,40,2011-08-22 19:00:10.438-04,12,1,13
6747,41,2011-08-22 19:00:10.438-04,16,3,19
6748,42,2011-08-22 19:00:10.438-04,5,14,19
6749,43,2011-08-22 19:00:10.438-04,2,13,15
6750,44,2011-08-22 19:00:10.438-04,15,4,19
6751,45,2011-08-22 19:00:10.438-04,7,12,19
6752,46,2011-08-22 19:00:10.438-04,14,5,19
6753,47,2011-08-22 19:00:10.438-04,11,0,11
6754,48,2011-08-22 19:00:10.438-04,2,13,15
6755,49,2011-08-22 19:00:10.438-04,9,6,15
6756,50,2011-08-22 19:00:10.438-04,3,12,15
6757,51,2011-08-22 19:00:10.438-04,6,9,15
6758,52,2011-08-22 19:00:10.438-04,7,7,14
6759,53,2011-08-22 19:00:10.438-04,10,5,15
6760,55,2011-08-22 19:00:10.438-04,4,11,15
6761,56,2011-08-22 19:00:10.438-04,4,11,15
6762,57,2011-08-22 19:00:10.438-04,5,6,11
6763,3,2011-08-22 19:01:11.379-04,9,8,17
6764,5,2011-08-22 19:01:11.379-04,6,9,15
6765,6,2011-08-22 19:01:11.379-04,12,3,15
6766,8,2011-08-22 19:01:11.379-04,2,13,15
6767,9,2011-08-22 19:01:11.379-04,6,13,19
6768,10,2011-08-22 19:01:11.379-04,4,15,19
6769,11,2011-08-22 19:01:11.379-04,1,14,15
6770,12,2011-08-22 19:01:11.379-04,10,5,15
6771,13,2011-08-22 19:01:11.379-04,7,8,15
6772,14,2011-08-22 19:01:11.379-04,0,17,17
6773,15,2011-08-22 19:01:11.379-04,8,7,15
6774,16,2011-08-22 19:01:11.379-04,12,7,19
6775,17,2011-08-22 19:01:11.379-04,5,10,15
6776,18,2011-08-22 19:01:11.379-04,7,8,15
6777,20,2011-08-22 19:01:11.379-04,11,8,19
6778,21,2011-08-22 19:01:11.379-04,5,18,23
6779,22,2011-08-22 19:01:11.379-04,22,25,47
6780,23,2011-08-22 19:01:11.379-04,4,14,18
6781,24,2011-08-22 19:01:11.379-04,1,14,15
6782,25,2011-08-22 19:01:11.379-04,8,7,15
6783,26,2011-08-22 19:01:11.379-04,7,8,15
6784,27,2011-08-22 19:01:11.379-04,5,9,14
6785,30,2011-08-22 19:01:11.379-04,11,4,15
6786,31,2011-08-22 19:01:11.379-04,5,6,11
6787,32,2011-08-22 19:01:11.379-04,7,4,11
6788,33,2011-08-22 19:01:11.379-04,6,13,19
6789,34,2011-08-22 19:01:11.379-04,8,7,15
6790,35,2011-08-22 19:01:11.379-04,0,11,11
6791,36,2011-08-22 19:01:11.379-04,0,15,15
6792,37,2011-08-22 19:01:11.379-04,8,7,15
6793,38,2011-08-22 19:01:11.379-04,27,8,35
6794,39,2011-08-22 19:01:11.379-04,9,10,19
6795,40,2011-08-22 19:01:11.379-04,12,1,13
6796,41,2011-08-22 19:01:11.379-04,16,3,19
6797,42,2011-08-22 19:01:11.379-04,5,14,19
6798,43,2011-08-22 19:01:11.379-04,2,13,15
6799,44,2011-08-22 19:01:11.379-04,14,5,19
6800,45,2011-08-22 19:01:11.379-04,5,14,19
6801,46,2011-08-22 19:01:11.379-04,15,4,19
6802,47,2011-08-22 19:01:11.379-04,11,0,11
6803,48,2011-08-22 19:01:11.379-04,2,13,15
6804,49,2011-08-22 19:01:11.379-04,10,5,15
6805,50,2011-08-22 19:01:11.379-04,3,12,15
6806,51,2011-08-22 19:01:11.379-04,6,9,15
6807,52,2011-08-22 19:01:11.379-04,7,7,14
6808,53,2011-08-22 19:01:11.379-04,10,5,15
6809,55,2011-08-22 19:01:11.379-04,4,11,15
6810,56,2011-08-22 19:01:11.379-04,4,11,15
6811,57,2011-08-22 19:01:11.379-04,4,7,11
6812,3,2011-08-22 19:02:12.365-04,9,8,17
6813,5,2011-08-22 19:02:12.365-04,6,9,15
6814,6,2011-08-22 19:02:12.365-04,12,3,15
6815,8,2011-08-22 19:02:12.365-04,2,13,15
6816,9,2011-08-22 19:02:12.365-04,6,13,19
6817,10,2011-08-22 19:02:12.365-04,4,15,19
6818,11,2011-08-22 19:02:12.365-04,1,14,15
6819,12,2011-08-22 19:02:12.365-04,10,5,15
6820,13,2011-08-22 19:02:12.365-04,7,8,15
6821,14,2011-08-22 19:02:12.365-04,0,17,17
6822,15,2011-08-22 19:02:12.365-04,8,7,15
6823,16,2011-08-22 19:02:12.365-04,11,8,19
6824,17,2011-08-22 19:02:12.365-04,5,10,15
6825,18,2011-08-22 19:02:12.365-04,7,8,15
6826,20,2011-08-22 19:02:12.365-04,11,8,19
6827,21,2011-08-22 19:02:12.365-04,5,18,23
6828,22,2011-08-22 19:02:12.365-04,22,25,47
6829,23,2011-08-22 19:02:12.365-04,4,14,18
6830,24,2011-08-22 19:02:12.365-04,1,14,15
6831,25,2011-08-22 19:02:12.365-04,8,7,15
6832,26,2011-08-22 19:02:12.365-04,7,8,15
6833,27,2011-08-22 19:02:12.365-04,5,9,14
6834,30,2011-08-22 19:02:12.365-04,11,4,15
6835,31,2011-08-22 19:02:12.365-04,5,6,11
6836,32,2011-08-22 19:02:12.365-04,7,4,11
6837,33,2011-08-22 19:02:12.365-04,6,13,19
6838,34,2011-08-22 19:02:12.365-04,8,7,15
6839,35,2011-08-22 19:02:12.365-04,0,11,11
6840,36,2011-08-22 19:02:12.365-04,0,15,15
6841,37,2011-08-22 19:02:12.365-04,8,7,15
6842,38,2011-08-22 19:02:12.365-04,27,8,35
6843,39,2011-08-22 19:02:12.365-04,9,10,19
6844,40,2011-08-22 19:02:12.365-04,12,1,13
6845,41,2011-08-22 19:02:12.365-04,16,3,19
6846,42,2011-08-22 19:02:12.365-04,5,14,19
6847,43,2011-08-22 19:02:12.365-04,2,13,15
6848,44,2011-08-22 19:02:12.365-04,14,5,19
6849,45,2011-08-22 19:02:12.365-04,5,14,19
6850,46,2011-08-22 19:02:12.365-04,15,4,19
6851,47,2011-08-22 19:02:12.365-04,11,0,11
6852,48,2011-08-22 19:02:12.365-04,2,13,15
6853,49,2011-08-22 19:02:12.365-04,10,5,15
6854,50,2011-08-22 19:02:12.365-04,3,12,15
6855,51,2011-08-22 19:02:12.365-04,6,9,15
6856,52,2011-08-22 19:02:12.365-04,7,7,14
6857,53,2011-08-22 19:02:12.365-04,10,5,15
6858,55,2011-08-22 19:02:12.365-04,4,11,15
6859,56,2011-08-22 19:02:12.365-04,4,11,15
6860,57,2011-08-22 19:02:12.365-04,4,7,11
6861,3,2011-08-22 19:03:13.304-04,9,8,17
6862,5,2011-08-22 19:03:13.304-04,6,9,15
6863,6,2011-08-22 19:03:13.304-04,12,3,15
6864,8,2011-08-22 19:03:13.304-04,2,13,15
6865,9,2011-08-22 19:03:13.304-04,6,13,19
6866,10,2011-08-22 19:03:13.304-04,4,15,19
6867,11,2011-08-22 19:03:13.304-04,1,14,15
6868,12,2011-08-22 19:03:13.304-04,10,5,15
6869,13,2011-08-22 19:03:13.304-04,7,8,15
6870,14,2011-08-22 19:03:13.304-04,0,17,17
6871,15,2011-08-22 19:03:13.304-04,8,7,15
6872,16,2011-08-22 19:03:13.304-04,11,8,19
6873,17,2011-08-22 19:03:13.304-04,5,10,15
6874,18,2011-08-22 19:03:13.304-04,7,8,15
6875,20,2011-08-22 19:03:13.304-04,11,8,19
6876,21,2011-08-22 19:03:13.304-04,5,18,23
6877,22,2011-08-22 19:03:13.304-04,22,25,47
6878,23,2011-08-22 19:03:13.304-04,4,14,18
6879,24,2011-08-22 19:03:13.304-04,1,14,15
6880,25,2011-08-22 19:03:13.304-04,8,7,15
6881,26,2011-08-22 19:03:13.304-04,7,8,15
6882,27,2011-08-22 19:03:13.304-04,5,9,14
6883,30,2011-08-22 19:03:13.304-04,11,4,15
6884,31,2011-08-22 19:03:13.304-04,5,6,11
6885,32,2011-08-22 19:03:13.304-04,7,4,11
6886,33,2011-08-22 19:03:13.304-04,6,13,19
6887,34,2011-08-22 19:03:13.304-04,8,7,15
6888,35,2011-08-22 19:03:13.304-04,0,11,11
6889,36,2011-08-22 19:03:13.304-04,1,14,15
6890,37,2011-08-22 19:03:13.304-04,8,7,15
6891,38,2011-08-22 19:03:13.304-04,27,8,35
6892,39,2011-08-22 19:03:13.304-04,9,10,19
6893,40,2011-08-22 19:03:13.304-04,12,1,13
6894,41,2011-08-22 19:03:13.304-04,16,3,19
6895,42,2011-08-22 19:03:13.304-04,5,14,19
6896,43,2011-08-22 19:03:13.304-04,2,13,15
6897,44,2011-08-22 19:03:13.304-04,14,5,19
6898,45,2011-08-22 19:03:13.304-04,5,14,19
6899,46,2011-08-22 19:03:13.304-04,15,4,19
6900,47,2011-08-22 19:03:13.304-04,11,0,11
6901,48,2011-08-22 19:03:13.304-04,2,13,15
6902,49,2011-08-22 19:03:13.304-04,10,5,15
6903,50,2011-08-22 19:03:13.304-04,2,13,15
6904,51,2011-08-22 19:03:13.304-04,6,9,15
6905,52,2011-08-22 19:03:13.304-04,7,7,14
6906,53,2011-08-22 19:03:13.304-04,10,5,15
6907,55,2011-08-22 19:03:13.304-04,4,11,15
6908,56,2011-08-22 19:03:13.304-04,4,11,15
6909,57,2011-08-22 19:03:13.304-04,4,7,11
6910,3,2011-08-22 19:04:14.22-04,9,8,17
6911,5,2011-08-22 19:04:14.22-04,6,9,15
6912,6,2011-08-22 19:04:14.22-04,13,2,15
6913,8,2011-08-22 19:04:14.22-04,2,13,15
6914,9,2011-08-22 19:04:14.22-04,6,13,19
6915,10,2011-08-22 19:04:14.22-04,4,15,19
6916,11,2011-08-22 19:04:14.22-04,1,14,15
6917,12,2011-08-22 19:04:14.22-04,10,5,15
6918,13,2011-08-22 19:04:14.22-04,7,8,15
6919,14,2011-08-22 19:04:14.22-04,0,17,17
6920,15,2011-08-22 19:04:14.22-04,8,7,15
6921,16,2011-08-22 19:04:14.22-04,11,8,19
6922,17,2011-08-22 19:04:14.22-04,5,10,15
6923,18,2011-08-22 19:04:14.22-04,7,8,15
6924,20,2011-08-22 19:04:14.22-04,11,8,19
6925,21,2011-08-22 19:04:14.22-04,5,18,23
6926,22,2011-08-22 19:04:14.22-04,21,26,47
6927,23,2011-08-22 19:04:14.22-04,4,14,18
6928,24,2011-08-22 19:04:14.22-04,1,14,15
6929,25,2011-08-22 19:04:14.22-04,8,7,15
6930,26,2011-08-22 19:04:14.22-04,7,8,15
6931,27,2011-08-22 19:04:14.22-04,5,9,14
6932,30,2011-08-22 19:04:14.22-04,11,4,15
6933,31,2011-08-22 19:04:14.22-04,5,6,11
6934,32,2011-08-22 19:04:14.22-04,7,4,11
6935,33,2011-08-22 19:04:14.22-04,6,13,19
6936,34,2011-08-22 19:04:14.22-04,8,7,15
6937,35,2011-08-22 19:04:14.22-04,0,11,11
6938,36,2011-08-22 19:04:14.22-04,1,14,15
6939,37,2011-08-22 19:04:14.22-04,8,7,15
6940,38,2011-08-22 19:04:14.22-04,27,8,35
6941,39,2011-08-22 19:04:14.22-04,7,12,19
6942,40,2011-08-22 19:04:14.22-04,12,1,13
6943,41,2011-08-22 19:04:14.22-04,16,3,19
6944,42,2011-08-22 19:04:14.22-04,5,14,19
6945,43,2011-08-22 19:04:14.22-04,2,13,15
6946,44,2011-08-22 19:04:14.22-04,14,5,19
6947,45,2011-08-22 19:04:14.22-04,5,14,19
6948,46,2011-08-22 19:04:14.22-04,15,4,19
6949,47,2011-08-22 19:04:14.22-04,11,0,11
6950,48,2011-08-22 19:04:14.22-04,2,13,15
6951,49,2011-08-22 19:04:14.22-04,10,5,15
6952,50,2011-08-22 19:04:14.22-04,2,13,15
6953,51,2011-08-22 19:04:14.22-04,6,9,15
6954,52,2011-08-22 19:04:14.22-04,6,8,14
6955,53,2011-08-22 19:04:14.22-04,10,5,15
6956,55,2011-08-22 19:04:14.22-04,4,11,15
6957,56,2011-08-22 19:04:14.22-04,4,11,15
6958,57,2011-08-22 19:04:14.22-04,4,7,11
6959,3,2011-08-22 19:05:15.157-04,9,8,17
6960,5,2011-08-22 19:05:15.157-04,6,9,15
6961,6,2011-08-22 19:05:15.157-04,13,2,15
6962,8,2011-08-22 19:05:15.157-04,2,13,15
6963,9,2011-08-22 19:05:15.157-04,6,13,19
6964,10,2011-08-22 19:05:15.157-04,4,15,19
6965,11,2011-08-22 19:05:15.157-04,1,14,15
6966,12,2011-08-22 19:05:15.157-04,10,5,15
6967,13,2011-08-22 19:05:15.157-04,7,8,15
6968,14,2011-08-22 19:05:15.157-04,0,17,17
6969,15,2011-08-22 19:05:15.157-04,8,7,15
6970,16,2011-08-22 19:05:15.157-04,11,8,19
6971,17,2011-08-22 19:05:15.157-04,5,10,15
6972,18,2011-08-22 19:05:15.157-04,7,8,15
6973,20,2011-08-22 19:05:15.157-04,11,8,19
6974,21,2011-08-22 19:05:15.157-04,5,18,23
6975,22,2011-08-22 19:05:15.157-04,21,26,47
6976,23,2011-08-22 19:05:15.157-04,4,14,18
6977,24,2011-08-22 19:05:15.157-04,1,14,15
6978,25,2011-08-22 19:05:15.157-04,8,7,15
6979,26,2011-08-22 19:05:15.157-04,7,8,15
6980,27,2011-08-22 19:05:15.157-04,5,9,14
6981,30,2011-08-22 19:05:15.157-04,11,4,15
6982,31,2011-08-22 19:05:15.157-04,5,6,11
6983,32,2011-08-22 19:05:15.157-04,7,4,11
6984,33,2011-08-22 19:05:15.157-04,6,13,19
6985,34,2011-08-22 19:05:15.157-04,8,7,15
6986,35,2011-08-22 19:05:15.157-04,0,11,11
6987,36,2011-08-22 19:05:15.157-04,1,14,15
6988,37,2011-08-22 19:05:15.157-04,8,7,15
6989,38,2011-08-22 19:05:15.157-04,27,8,35
6990,39,2011-08-22 19:05:15.157-04,7,12,19
6991,40,2011-08-22 19:05:15.157-04,12,1,13
6992,41,2011-08-22 19:05:15.157-04,16,3,19
6993,42,2011-08-22 19:05:15.157-04,5,14,19
6994,43,2011-08-22 19:05:15.157-04,2,13,15
6995,44,2011-08-22 19:05:15.157-04,14,5,19
6996,45,2011-08-22 19:05:15.157-04,5,14,19
6997,46,2011-08-22 19:05:15.157-04,15,4,19
6998,47,2011-08-22 19:05:15.157-04,11,0,11
6999,48,2011-08-22 19:05:15.157-04,2,13,15
7000,49,2011-08-22 19:05:15.157-04,10,5,15
7001,50,2011-08-22 19:05:15.157-04,2,13,15
7002,51,2011-08-22 19:05:15.157-04,6,9,15
7003,52,2011-08-22 19:05:15.157-04,6,8,14
7004,53,2011-08-22 19:05:15.157-04,10,5,15
7005,55,2011-08-22 19:05:15.157-04,4,11,15
7006,56,2011-08-22 19:05:15.157-04,4,11,15
7007,57,2011-08-22 19:05:15.157-04,3,8,11
7008,3,2011-08-22 19:06:16.355-04,9,8,17
7009,5,2011-08-22 19:06:16.355-04,6,9,15
7010,6,2011-08-22 19:06:16.355-04,13,2,15
7011,8,2011-08-22 19:06:16.355-04,2,13,15
7012,9,2011-08-22 19:06:16.355-04,6,13,19
7013,10,2011-08-22 19:06:16.355-04,4,15,19
7014,11,2011-08-22 19:06:16.355-04,1,14,15
7015,12,2011-08-22 19:06:16.355-04,10,5,15
7016,13,2011-08-22 19:06:16.355-04,7,8,15
7017,14,2011-08-22 19:06:16.355-04,0,17,17
7018,15,2011-08-22 19:06:16.355-04,8,7,15
7019,16,2011-08-22 19:06:16.355-04,11,8,19
7020,17,2011-08-22 19:06:16.355-04,5,10,15
7021,18,2011-08-22 19:06:16.355-04,7,8,15
7022,20,2011-08-22 19:06:16.355-04,11,8,19
7023,21,2011-08-22 19:06:16.355-04,5,18,23
7024,22,2011-08-22 19:06:16.355-04,21,26,47
7025,23,2011-08-22 19:06:16.355-04,4,14,18
7026,24,2011-08-22 19:06:16.355-04,1,14,15
7027,25,2011-08-22 19:06:16.355-04,8,7,15
7028,26,2011-08-22 19:06:16.355-04,7,8,15
7029,27,2011-08-22 19:06:16.355-04,5,9,14
7030,30,2011-08-22 19:06:16.355-04,11,4,15
7031,31,2011-08-22 19:06:16.355-04,5,6,11
7032,32,2011-08-22 19:06:16.355-04,7,4,11
7033,33,2011-08-22 19:06:16.355-04,6,13,19
7034,34,2011-08-22 19:06:16.355-04,8,7,15
7035,35,2011-08-22 19:06:16.355-04,0,11,11
7036,36,2011-08-22 19:06:16.355-04,1,14,15
7037,37,2011-08-22 19:06:16.355-04,8,7,15
7038,38,2011-08-22 19:06:16.355-04,27,8,35
7039,39,2011-08-22 19:06:16.355-04,7,12,19
7040,40,2011-08-22 19:06:16.355-04,12,1,13
7041,41,2011-08-22 19:06:16.355-04,16,3,19
7042,42,2011-08-22 19:06:16.355-04,5,14,19
7043,43,2011-08-22 19:06:16.355-04,2,13,15
7044,44,2011-08-22 19:06:16.355-04,14,5,19
7045,45,2011-08-22 19:06:16.355-04,5,14,19
7046,46,2011-08-22 19:06:16.355-04,15,4,19
7047,47,2011-08-22 19:06:16.355-04,11,0,11
7048,48,2011-08-22 19:06:16.355-04,2,13,15
7049,49,2011-08-22 19:06:16.355-04,10,5,15
7050,50,2011-08-22 19:06:16.355-04,2,13,15
7051,51,2011-08-22 19:06:16.355-04,6,9,15
7052,52,2011-08-22 19:06:16.355-04,6,8,14
7053,53,2011-08-22 19:06:16.355-04,10,5,15
7054,55,2011-08-22 19:06:16.355-04,4,11,15
7055,56,2011-08-22 19:06:16.355-04,4,11,15
7056,57,2011-08-22 19:06:16.355-04,3,8,11
7057,3,2011-08-22 19:07:17.561-04,9,8,17
7058,5,2011-08-22 19:07:17.561-04,6,9,15
7059,6,2011-08-22 19:07:17.561-04,14,1,15
7060,8,2011-08-22 19:07:17.561-04,2,13,15
7061,9,2011-08-22 19:07:17.561-04,6,13,19
7062,10,2011-08-22 19:07:17.561-04,4,15,19
7063,11,2011-08-22 19:07:17.561-04,1,14,15
7064,12,2011-08-22 19:07:17.561-04,10,5,15
7065,13,2011-08-22 19:07:17.561-04,7,8,15
7066,14,2011-08-22 19:07:17.561-04,0,17,17
7067,15,2011-08-22 19:07:17.561-04,8,7,15
7068,16,2011-08-22 19:07:17.561-04,11,8,19
7069,17,2011-08-22 19:07:17.561-04,5,10,15
7070,18,2011-08-22 19:07:17.561-04,7,8,15
7071,20,2011-08-22 19:07:17.561-04,11,8,19
7072,21,2011-08-22 19:07:17.561-04,5,18,23
7073,22,2011-08-22 19:07:17.561-04,21,26,47
7074,23,2011-08-22 19:07:17.561-04,4,14,18
7075,24,2011-08-22 19:07:17.561-04,1,14,15
7076,25,2011-08-22 19:07:17.561-04,8,7,15
7077,26,2011-08-22 19:07:17.561-04,7,8,15
7078,27,2011-08-22 19:07:17.561-04,5,9,14
7079,30,2011-08-22 19:07:17.561-04,11,4,15
7080,31,2011-08-22 19:07:17.561-04,5,6,11
7081,32,2011-08-22 19:07:17.561-04,7,4,11
7082,33,2011-08-22 19:07:17.561-04,6,13,19
7083,34,2011-08-22 19:07:17.561-04,8,7,15
7084,35,2011-08-22 19:07:17.561-04,0,11,11
7085,36,2011-08-22 19:07:17.561-04,1,14,15
7086,37,2011-08-22 19:07:17.561-04,8,7,15
7087,38,2011-08-22 19:07:17.561-04,27,8,35
7088,39,2011-08-22 19:07:17.561-04,7,12,19
7089,40,2011-08-22 19:07:17.561-04,12,1,13
7090,41,2011-08-22 19:07:17.561-04,16,3,19
7091,42,2011-08-22 19:07:17.561-04,5,14,19
7092,43,2011-08-22 19:07:17.561-04,2,13,15
7093,44,2011-08-22 19:07:17.561-04,14,5,19
7094,45,2011-08-22 19:07:17.561-04,5,14,19
7095,46,2011-08-22 19:07:17.561-04,15,4,19
7096,47,2011-08-22 19:07:17.561-04,11,0,11
7097,48,2011-08-22 19:07:17.561-04,2,13,15
7098,49,2011-08-22 19:07:17.561-04,10,5,15
7099,50,2011-08-22 19:07:17.561-04,2,13,15
7100,51,2011-08-22 19:07:17.561-04,6,9,15
7101,52,2011-08-22 19:07:17.561-04,6,8,14
7102,53,2011-08-22 19:07:17.561-04,10,5,15
7103,55,2011-08-22 19:07:17.561-04,4,11,15
7104,56,2011-08-22 19:07:17.561-04,4,11,15
7105,57,2011-08-22 19:07:17.561-04,3,8,11
7106,3,2011-08-22 19:08:18.981-04,9,8,17
7107,5,2011-08-22 19:08:18.981-04,6,9,15
7108,6,2011-08-22 19:08:18.981-04,14,1,15
7109,8,2011-08-22 19:08:18.981-04,2,13,15
7110,9,2011-08-22 19:08:18.981-04,6,13,19
7111,10,2011-08-22 19:08:18.981-04,4,15,19
7112,11,2011-08-22 19:08:18.981-04,1,14,15
7113,12,2011-08-22 19:08:18.981-04,10,5,15
7114,13,2011-08-22 19:08:18.981-04,7,8,15
7115,14,2011-08-22 19:08:18.981-04,0,17,17
7116,15,2011-08-22 19:08:18.981-04,8,7,15
7117,16,2011-08-22 19:08:18.981-04,11,8,19
7118,17,2011-08-22 19:08:18.981-04,5,10,15
7119,18,2011-08-22 19:08:18.981-04,7,8,15
7120,20,2011-08-22 19:08:18.981-04,11,8,19
7121,21,2011-08-22 19:08:18.981-04,5,18,23
7122,22,2011-08-22 19:08:18.981-04,21,26,47
7123,23,2011-08-22 19:08:18.981-04,4,14,18
7124,24,2011-08-22 19:08:18.981-04,1,14,15
7125,25,2011-08-22 19:08:18.981-04,8,7,15
7126,26,2011-08-22 19:08:18.981-04,7,8,15
7127,27,2011-08-22 19:08:18.981-04,5,9,14
7128,30,2011-08-22 19:08:18.981-04,11,4,15
7129,31,2011-08-22 19:08:18.981-04,5,6,11
7130,32,2011-08-22 19:08:18.981-04,7,4,11
7131,33,2011-08-22 19:08:18.981-04,6,13,19
7132,34,2011-08-22 19:08:18.981-04,8,7,15
7133,35,2011-08-22 19:08:18.981-04,0,11,11
7134,36,2011-08-22 19:08:18.981-04,2,13,15
7135,37,2011-08-22 19:08:18.981-04,8,7,15
7136,38,2011-08-22 19:08:18.981-04,27,8,35
7137,39,2011-08-22 19:08:18.981-04,7,12,19
7138,40,2011-08-22 19:08:18.981-04,12,1,13
7139,41,2011-08-22 19:08:18.981-04,16,3,19
7140,42,2011-08-22 19:08:18.981-04,5,14,19
7141,43,2011-08-22 19:08:18.981-04,2,13,15
7142,44,2011-08-22 19:08:18.981-04,14,5,19
7143,45,2011-08-22 19:08:18.981-04,3,16,19
7144,46,2011-08-22 19:08:18.981-04,15,4,19
7145,47,2011-08-22 19:08:18.981-04,11,0,11
7146,48,2011-08-22 19:08:18.981-04,2,13,15
7147,49,2011-08-22 19:08:18.981-04,10,5,15
7148,50,2011-08-22 19:08:18.981-04,2,13,15
7149,51,2011-08-22 19:08:18.981-04,6,9,15
7150,52,2011-08-22 19:08:18.981-04,6,8,14
7151,53,2011-08-22 19:08:18.981-04,10,5,15
7152,55,2011-08-22 19:08:18.981-04,4,11,15
7153,56,2011-08-22 19:08:18.981-04,4,11,15
7154,57,2011-08-22 19:08:18.981-04,3,8,11
7155,3,2011-08-22 19:09:20.064-04,9,8,17
7156,5,2011-08-22 19:09:20.064-04,6,9,15
7157,6,2011-08-22 19:09:20.064-04,14,1,15
7158,8,2011-08-22 19:09:20.064-04,2,13,15
7159,9,2011-08-22 19:09:20.064-04,6,13,19
7160,10,2011-08-22 19:09:20.064-04,4,15,19
7161,11,2011-08-22 19:09:20.064-04,1,14,15
7162,12,2011-08-22 19:09:20.064-04,10,5,15
7163,13,2011-08-22 19:09:20.064-04,7,8,15
7164,14,2011-08-22 19:09:20.064-04,0,17,17
7165,15,2011-08-22 19:09:20.064-04,8,7,15
7166,16,2011-08-22 19:09:20.064-04,11,8,19
7167,17,2011-08-22 19:09:20.064-04,5,10,15
7168,18,2011-08-22 19:09:20.064-04,7,8,15
7169,20,2011-08-22 19:09:20.064-04,12,7,19
7170,21,2011-08-22 19:09:20.064-04,5,18,23
7171,22,2011-08-22 19:09:20.064-04,21,26,47
7172,23,2011-08-22 19:09:20.064-04,4,14,18
7173,24,2011-08-22 19:09:20.064-04,1,14,15
7174,25,2011-08-22 19:09:20.064-04,8,7,15
7175,26,2011-08-22 19:09:20.064-04,7,8,15
7176,27,2011-08-22 19:09:20.064-04,5,9,14
7177,30,2011-08-22 19:09:20.064-04,11,4,15
7178,31,2011-08-22 19:09:20.064-04,5,6,11
7179,32,2011-08-22 19:09:20.064-04,7,4,11
7180,33,2011-08-22 19:09:20.064-04,6,13,19
7181,34,2011-08-22 19:09:20.064-04,8,7,15
7182,35,2011-08-22 19:09:20.064-04,0,11,11
7183,36,2011-08-22 19:09:20.064-04,2,13,15
7184,37,2011-08-22 19:09:20.064-04,8,7,15
7185,38,2011-08-22 19:09:20.064-04,28,7,35
7186,39,2011-08-22 19:09:20.064-04,7,12,19
7187,40,2011-08-22 19:09:20.064-04,12,1,13
7188,41,2011-08-22 19:09:20.064-04,16,3,19
7189,42,2011-08-22 19:09:20.064-04,5,14,19
7190,43,2011-08-22 19:09:20.064-04,2,13,15
7191,44,2011-08-22 19:09:20.064-04,14,5,19
7192,45,2011-08-22 19:09:20.064-04,3,16,19
7193,46,2011-08-22 19:09:20.064-04,15,4,19
7194,47,2011-08-22 19:09:20.064-04,11,0,11
7195,48,2011-08-22 19:09:20.064-04,2,13,15
7196,49,2011-08-22 19:09:20.064-04,10,5,15
7197,50,2011-08-22 19:09:20.064-04,2,13,15
7198,51,2011-08-22 19:09:20.064-04,6,9,15
7199,52,2011-08-22 19:09:20.064-04,6,8,14
7200,53,2011-08-22 19:09:20.064-04,10,5,15
7201,55,2011-08-22 19:09:20.064-04,4,11,15
7202,56,2011-08-22 19:09:20.064-04,4,11,15
7203,57,2011-08-22 19:09:20.064-04,3,8,11
7204,3,2011-08-22 19:10:20.924-04,9,8,17
7205,5,2011-08-22 19:10:20.924-04,6,9,15
7206,6,2011-08-22 19:10:20.924-04,14,1,15
7207,8,2011-08-22 19:10:20.924-04,2,13,15
7208,9,2011-08-22 19:10:20.924-04,6,13,19
7209,10,2011-08-22 19:10:20.924-04,4,15,19
7210,11,2011-08-22 19:10:20.924-04,1,14,15
7211,12,2011-08-22 19:10:20.924-04,10,5,15
7212,13,2011-08-22 19:10:20.924-04,7,8,15
7213,14,2011-08-22 19:10:20.924-04,0,17,17
7214,15,2011-08-22 19:10:20.924-04,8,7,15
7215,16,2011-08-22 19:10:20.924-04,11,8,19
7216,17,2011-08-22 19:10:20.924-04,5,10,15
7217,18,2011-08-22 19:10:20.924-04,7,8,15
7218,20,2011-08-22 19:10:20.924-04,12,7,19
7219,21,2011-08-22 19:10:20.924-04,5,18,23
7220,22,2011-08-22 19:10:20.924-04,21,26,47
7221,23,2011-08-22 19:10:20.924-04,4,14,18
7222,24,2011-08-22 19:10:20.924-04,1,14,15
7223,25,2011-08-22 19:10:20.924-04,8,7,15
7224,26,2011-08-22 19:10:20.924-04,7,8,15
7225,27,2011-08-22 19:10:20.924-04,5,9,14
7226,30,2011-08-22 19:10:20.924-04,11,4,15
7227,31,2011-08-22 19:10:20.924-04,5,6,11
7228,32,2011-08-22 19:10:20.924-04,9,2,11
7229,33,2011-08-22 19:10:20.924-04,6,13,19
7230,34,2011-08-22 19:10:20.924-04,8,7,15
7231,35,2011-08-22 19:10:20.924-04,0,11,11
7232,36,2011-08-22 19:10:20.924-04,2,13,15
7233,37,2011-08-22 19:10:20.924-04,8,7,15
7234,38,2011-08-22 19:10:20.924-04,28,7,35
7235,39,2011-08-22 19:10:20.924-04,7,12,19
7236,40,2011-08-22 19:10:20.924-04,12,1,13
7237,41,2011-08-22 19:10:20.924-04,16,3,19
7238,42,2011-08-22 19:10:20.924-04,5,14,19
7239,43,2011-08-22 19:10:20.924-04,1,14,15
7240,44,2011-08-22 19:10:20.924-04,14,5,19
7241,45,2011-08-22 19:10:20.924-04,3,16,19
7242,46,2011-08-22 19:10:20.924-04,17,2,19
7243,47,2011-08-22 19:10:20.924-04,11,0,11
7244,48,2011-08-22 19:10:20.924-04,2,13,15
7245,49,2011-08-22 19:10:20.924-04,10,5,15
7246,50,2011-08-22 19:10:20.924-04,2,13,15
7247,51,2011-08-22 19:10:20.924-04,6,9,15
7248,52,2011-08-22 19:10:20.924-04,6,8,14
7249,53,2011-08-22 19:10:20.924-04,10,5,15
7250,55,2011-08-22 19:10:20.924-04,4,11,15
7251,56,2011-08-22 19:10:20.924-04,4,11,15
7252,57,2011-08-22 19:10:20.924-04,3,8,11
7253,3,2011-08-22 19:11:21.931-04,9,8,17
7254,5,2011-08-22 19:11:21.931-04,6,9,15
7255,6,2011-08-22 19:11:21.931-04,14,1,15
7256,8,2011-08-22 19:11:21.931-04,2,13,15
7257,9,2011-08-22 19:11:21.931-04,6,13,19
7258,10,2011-08-22 19:11:21.931-04,4,15,19
7259,11,2011-08-22 19:11:21.931-04,1,14,15
7260,12,2011-08-22 19:11:21.931-04,10,5,15
7261,13,2011-08-22 19:11:21.931-04,7,8,15
7262,14,2011-08-22 19:11:21.931-04,0,17,17
7263,15,2011-08-22 19:11:21.931-04,8,7,15
7264,16,2011-08-22 19:11:21.931-04,11,8,19
7265,17,2011-08-22 19:11:21.931-04,5,10,15
7266,18,2011-08-22 19:11:21.931-04,7,8,15
7267,20,2011-08-22 19:11:21.931-04,12,7,19
7268,21,2011-08-22 19:11:21.931-04,5,18,23
7269,22,2011-08-22 19:11:21.931-04,20,27,47
7270,23,2011-08-22 19:11:21.931-04,4,14,18
7271,24,2011-08-22 19:11:21.931-04,1,14,15
7272,25,2011-08-22 19:11:21.931-04,8,7,15
7273,26,2011-08-22 19:11:21.931-04,8,7,15
7274,27,2011-08-22 19:11:21.931-04,5,9,14
7275,30,2011-08-22 19:11:21.931-04,11,4,15
7276,31,2011-08-22 19:11:21.931-04,5,6,11
7277,32,2011-08-22 19:11:21.931-04,9,2,11
7278,33,2011-08-22 19:11:21.931-04,6,13,19
7279,34,2011-08-22 19:11:21.931-04,8,7,15
7280,35,2011-08-22 19:11:21.931-04,0,11,11
7281,36,2011-08-22 19:11:21.931-04,2,13,15
7282,37,2011-08-22 19:11:21.931-04,8,7,15
7283,38,2011-08-22 19:11:21.931-04,28,7,35
7284,39,2011-08-22 19:11:21.931-04,7,12,19
7285,40,2011-08-22 19:11:21.931-04,12,1,13
7286,41,2011-08-22 19:11:21.931-04,16,3,19
7287,42,2011-08-22 19:11:21.931-04,5,14,19
7288,43,2011-08-22 19:11:21.931-04,1,14,15
7289,44,2011-08-22 19:11:21.931-04,16,3,19
7290,45,2011-08-22 19:11:21.931-04,3,16,19
7291,46,2011-08-22 19:11:21.931-04,17,2,19
7292,47,2011-08-22 19:11:21.931-04,11,0,11
7293,48,2011-08-22 19:11:21.931-04,2,13,15
7294,49,2011-08-22 19:11:21.931-04,10,5,15
7295,50,2011-08-22 19:11:21.931-04,2,13,15
7296,51,2011-08-22 19:11:21.931-04,6,9,15
7297,52,2011-08-22 19:11:21.931-04,6,8,14
7298,53,2011-08-22 19:11:21.931-04,10,5,15
7299,55,2011-08-22 19:11:21.931-04,4,11,15
7300,56,2011-08-22 19:11:21.931-04,4,11,15
7301,57,2011-08-22 19:11:21.931-04,3,8,11
7302,3,2011-08-22 19:12:22.917-04,9,8,17
7303,5,2011-08-22 19:12:22.917-04,6,9,15
7304,6,2011-08-22 19:12:22.917-04,14,1,15
7305,8,2011-08-22 19:12:22.917-04,1,14,15
7306,9,2011-08-22 19:12:22.917-04,6,13,19
7307,10,2011-08-22 19:12:22.917-04,4,15,19
7308,11,2011-08-22 19:12:22.917-04,1,14,15
7309,12,2011-08-22 19:12:22.917-04,10,5,15
7310,13,2011-08-22 19:12:22.917-04,7,8,15
7311,14,2011-08-22 19:12:22.917-04,0,17,17
7312,15,2011-08-22 19:12:22.917-04,8,7,15
7313,16,2011-08-22 19:12:22.917-04,11,8,19
7314,17,2011-08-22 19:12:22.917-04,5,10,15
7315,18,2011-08-22 19:12:22.917-04,7,8,15
7316,20,2011-08-22 19:12:22.917-04,12,7,19
7317,21,2011-08-22 19:12:22.917-04,5,18,23
7318,22,2011-08-22 19:12:22.917-04,20,27,47
7319,23,2011-08-22 19:12:22.917-04,4,14,18
7320,24,2011-08-22 19:12:22.917-04,1,14,15
7321,25,2011-08-22 19:12:22.917-04,8,7,15
7322,26,2011-08-22 19:12:22.917-04,8,7,15
7323,27,2011-08-22 19:12:22.917-04,5,9,14
7324,30,2011-08-22 19:12:22.917-04,11,4,15
7325,31,2011-08-22 19:12:22.917-04,5,6,11
7326,32,2011-08-22 19:12:22.917-04,9,2,11
7327,33,2011-08-22 19:12:22.917-04,6,13,19
7328,34,2011-08-22 19:12:22.917-04,8,7,15
7329,35,2011-08-22 19:12:22.917-04,0,11,11
7330,36,2011-08-22 19:12:22.917-04,2,13,15
7331,37,2011-08-22 19:12:22.917-04,8,7,15
7332,38,2011-08-22 19:12:22.917-04,28,7,35
7333,39,2011-08-22 19:12:22.917-04,7,12,19
7334,40,2011-08-22 19:12:22.917-04,12,1,13
7335,41,2011-08-22 19:12:22.917-04,17,2,19
7336,42,2011-08-22 19:12:22.917-04,5,14,19
7337,43,2011-08-22 19:12:22.917-04,1,14,15
7338,44,2011-08-22 19:12:22.917-04,16,3,19
7339,45,2011-08-22 19:12:22.917-04,3,16,19
7340,46,2011-08-22 19:12:22.917-04,15,4,19
7341,47,2011-08-22 19:12:22.917-04,11,0,11
7342,48,2011-08-22 19:12:22.917-04,2,13,15
7343,49,2011-08-22 19:12:22.917-04,10,5,15
7344,50,2011-08-22 19:12:22.917-04,1,14,15
7345,51,2011-08-22 19:12:22.917-04,6,9,15
7346,52,2011-08-22 19:12:22.917-04,6,8,14
7347,53,2011-08-22 19:12:22.917-04,11,4,15
7348,55,2011-08-22 19:12:22.917-04,4,11,15
7349,56,2011-08-22 19:12:22.917-04,4,11,15
7350,57,2011-08-22 19:12:22.917-04,3,8,11
7351,3,2011-08-22 19:13:23.77-04,9,8,17
7352,5,2011-08-22 19:13:23.77-04,6,9,15
7353,6,2011-08-22 19:13:23.77-04,14,1,15
7354,8,2011-08-22 19:13:23.77-04,1,14,15
7355,9,2011-08-22 19:13:23.77-04,6,13,19
7356,10,2011-08-22 19:13:23.77-04,4,15,19
7357,11,2011-08-22 19:13:23.77-04,1,14,15
7358,12,2011-08-22 19:13:23.77-04,10,5,15
7359,13,2011-08-22 19:13:23.77-04,7,8,15
7360,14,2011-08-22 19:13:23.77-04,0,17,17
7361,15,2011-08-22 19:13:23.77-04,8,7,15
7362,16,2011-08-22 19:13:23.77-04,10,9,19
7363,17,2011-08-22 19:13:23.77-04,5,10,15
7364,18,2011-08-22 19:13:23.77-04,7,8,15
7365,20,2011-08-22 19:13:23.77-04,13,6,19
7366,21,2011-08-22 19:13:23.77-04,5,18,23
7367,22,2011-08-22 19:13:23.77-04,20,27,47
7368,23,2011-08-22 19:13:23.77-04,4,14,18
7369,24,2011-08-22 19:13:23.77-04,1,14,15
7370,25,2011-08-22 19:13:23.77-04,8,7,15
7371,26,2011-08-22 19:13:23.77-04,8,7,15
7372,27,2011-08-22 19:13:23.77-04,5,9,14
7373,30,2011-08-22 19:13:23.77-04,11,4,15
7374,31,2011-08-22 19:13:23.77-04,5,6,11
7375,32,2011-08-22 19:13:23.77-04,9,2,11
7376,33,2011-08-22 19:13:23.77-04,6,13,19
7377,34,2011-08-22 19:13:23.77-04,8,7,15
7378,35,2011-08-22 19:13:23.77-04,0,11,11
7379,36,2011-08-22 19:13:23.77-04,1,14,15
7380,37,2011-08-22 19:13:23.77-04,8,7,15
7381,38,2011-08-22 19:13:23.77-04,28,7,35
7382,39,2011-08-22 19:13:23.77-04,7,12,19
7383,40,2011-08-22 19:13:23.77-04,12,1,13
7384,41,2011-08-22 19:13:23.77-04,17,2,19
7385,42,2011-08-22 19:13:23.77-04,5,14,19
7386,43,2011-08-22 19:13:23.77-04,1,14,15
7387,44,2011-08-22 19:13:23.77-04,16,3,19
7388,45,2011-08-22 19:13:23.77-04,3,16,19
7389,46,2011-08-22 19:13:23.77-04,15,4,19
7390,47,2011-08-22 19:13:23.77-04,11,0,11
7391,48,2011-08-22 19:13:23.77-04,2,13,15
7392,49,2011-08-22 19:13:23.77-04,10,5,15
7393,50,2011-08-22 19:13:23.77-04,0,15,15
7394,51,2011-08-22 19:13:23.77-04,6,9,15
7395,52,2011-08-22 19:13:23.77-04,6,8,14
7396,53,2011-08-22 19:13:23.77-04,11,4,15
7397,55,2011-08-22 19:13:23.77-04,4,11,15
7398,56,2011-08-22 19:13:23.77-04,4,11,15
7399,57,2011-08-22 19:13:23.77-04,3,8,11
7400,3,2011-08-22 19:14:24.632-04,9,8,17
7401,5,2011-08-22 19:14:24.632-04,6,9,15
7402,6,2011-08-22 19:14:24.632-04,14,1,15
7403,8,2011-08-22 19:14:24.632-04,1,14,15
7404,9,2011-08-22 19:14:24.632-04,6,13,19
7405,10,2011-08-22 19:14:24.632-04,4,15,19
7406,11,2011-08-22 19:14:24.632-04,1,14,15
7407,12,2011-08-22 19:14:24.632-04,10,5,15
7408,13,2011-08-22 19:14:24.632-04,7,8,15
7409,14,2011-08-22 19:14:24.632-04,0,17,17
7410,15,2011-08-22 19:14:24.632-04,8,7,15
7411,16,2011-08-22 19:14:24.632-04,9,10,19
7412,17,2011-08-22 19:14:24.632-04,5,10,15
7413,18,2011-08-22 19:14:24.632-04,7,8,15
7414,20,2011-08-22 19:14:24.632-04,13,6,19
7415,21,2011-08-22 19:14:24.632-04,5,18,23
7416,22,2011-08-22 19:14:24.632-04,20,27,47
7417,23,2011-08-22 19:14:24.632-04,4,14,18
7418,24,2011-08-22 19:14:24.632-04,1,14,15
7419,25,2011-08-22 19:14:24.632-04,8,7,15
7420,26,2011-08-22 19:14:24.632-04,8,7,15
7421,27,2011-08-22 19:14:24.632-04,5,9,14
7422,30,2011-08-22 19:14:24.632-04,11,4,15
7423,31,2011-08-22 19:14:24.632-04,5,6,11
7424,32,2011-08-22 19:14:24.632-04,9,2,11
7425,33,2011-08-22 19:14:24.632-04,7,12,19
7426,34,2011-08-22 19:14:24.632-04,8,7,15
7427,35,2011-08-22 19:14:24.632-04,0,11,11
7428,36,2011-08-22 19:14:24.632-04,1,14,15
7429,37,2011-08-22 19:14:24.632-04,8,7,15
7430,38,2011-08-22 19:14:24.632-04,28,7,35
7431,39,2011-08-22 19:14:24.632-04,7,12,19
7432,40,2011-08-22 19:14:24.632-04,11,2,13
7433,41,2011-08-22 19:14:24.632-04,17,2,19
7434,42,2011-08-22 19:14:24.632-04,4,15,19
7435,43,2011-08-22 19:14:24.632-04,1,14,15
7436,44,2011-08-22 19:14:24.632-04,16,3,19
7437,45,2011-08-22 19:14:24.632-04,3,16,19
7438,46,2011-08-22 19:14:24.632-04,15,4,19
7439,47,2011-08-22 19:14:24.632-04,11,0,11
7440,48,2011-08-22 19:14:24.632-04,2,13,15
7441,49,2011-08-22 19:14:24.632-04,10,5,15
7442,50,2011-08-22 19:14:24.632-04,0,15,15
7443,51,2011-08-22 19:14:24.632-04,6,9,15
7444,52,2011-08-22 19:14:24.632-04,6,8,14
7445,53,2011-08-22 19:14:24.632-04,11,4,15
7446,55,2011-08-22 19:14:24.632-04,4,11,15
7447,56,2011-08-22 19:14:24.632-04,4,11,15
7448,57,2011-08-22 19:14:24.632-04,3,8,11
7449,3,2011-08-22 19:15:25.54-04,9,8,17
7450,5,2011-08-22 19:15:25.54-04,6,9,15
7451,6,2011-08-22 19:15:25.54-04,14,1,15
7452,8,2011-08-22 19:15:25.54-04,1,14,15
7453,9,2011-08-22 19:15:25.54-04,6,13,19
7454,10,2011-08-22 19:15:25.54-04,4,15,19
7455,11,2011-08-22 19:15:25.54-04,1,14,15
7456,12,2011-08-22 19:15:25.54-04,10,5,15
7457,13,2011-08-22 19:15:25.54-04,7,8,15
7458,14,2011-08-22 19:15:25.54-04,0,17,17
7459,15,2011-08-22 19:15:25.54-04,8,7,15
7460,16,2011-08-22 19:15:25.54-04,9,10,19
7461,17,2011-08-22 19:15:25.54-04,5,10,15
7462,18,2011-08-22 19:15:25.54-04,7,8,15
7463,20,2011-08-22 19:15:25.54-04,13,6,19
7464,21,2011-08-22 19:15:25.54-04,5,18,23
7465,22,2011-08-22 19:15:25.54-04,20,27,47
7466,23,2011-08-22 19:15:25.54-04,4,14,18
7467,24,2011-08-22 19:15:25.54-04,1,14,15
7468,25,2011-08-22 19:15:25.54-04,8,7,15
7469,26,2011-08-22 19:15:25.54-04,8,7,15
7470,27,2011-08-22 19:15:25.54-04,5,9,14
7471,30,2011-08-22 19:15:25.54-04,11,4,15
7472,31,2011-08-22 19:15:25.54-04,5,6,11
7473,32,2011-08-22 19:15:25.54-04,9,2,11
7474,33,2011-08-22 19:15:25.54-04,7,12,19
7475,34,2011-08-22 19:15:25.54-04,8,7,15
7476,35,2011-08-22 19:15:25.54-04,0,11,11
7477,36,2011-08-22 19:15:25.54-04,3,12,15
7478,37,2011-08-22 19:15:25.54-04,8,7,15
7479,38,2011-08-22 19:15:25.54-04,28,7,35
7480,39,2011-08-22 19:15:25.54-04,7,12,19
7481,40,2011-08-22 19:15:25.54-04,11,2,13
7482,41,2011-08-22 19:15:25.54-04,17,2,19
7483,42,2011-08-22 19:15:25.54-04,4,15,19
7484,43,2011-08-22 19:15:25.54-04,1,14,15
7485,44,2011-08-22 19:15:25.54-04,16,3,19
7486,45,2011-08-22 19:15:25.54-04,3,16,19
7487,46,2011-08-22 19:15:25.54-04,15,4,19
7488,47,2011-08-22 19:15:25.54-04,11,0,11
7489,48,2011-08-22 19:15:25.54-04,2,13,15
7490,49,2011-08-22 19:15:25.54-04,10,5,15
7491,50,2011-08-22 19:15:25.54-04,0,15,15
7492,51,2011-08-22 19:15:25.54-04,6,9,15
7493,52,2011-08-22 19:15:25.54-04,6,8,14
7494,53,2011-08-22 19:15:25.54-04,11,4,15
7495,55,2011-08-22 19:15:25.54-04,4,11,15
7496,56,2011-08-22 19:15:25.54-04,4,11,15
7497,57,2011-08-22 19:15:25.54-04,3,8,11
7498,3,2011-08-22 19:16:26.421-04,9,8,17
7499,5,2011-08-22 19:16:26.421-04,6,9,15
7500,6,2011-08-22 19:16:26.421-04,14,1,15
7501,8,2011-08-22 19:16:26.421-04,1,14,15
7502,9,2011-08-22 19:16:26.421-04,6,13,19
7503,10,2011-08-22 19:16:26.421-04,4,15,19
7504,11,2011-08-22 19:16:26.421-04,1,14,15
7505,12,2011-08-22 19:16:26.421-04,10,5,15
7506,13,2011-08-22 19:16:26.421-04,7,8,15
7507,14,2011-08-22 19:16:26.421-04,0,17,17
7508,15,2011-08-22 19:16:26.421-04,8,7,15
7509,16,2011-08-22 19:16:26.421-04,9,10,19
7510,17,2011-08-22 19:16:26.421-04,5,10,15
7511,18,2011-08-22 19:16:26.421-04,7,8,15
7512,20,2011-08-22 19:16:26.421-04,13,6,19
7513,21,2011-08-22 19:16:26.421-04,5,18,23
7514,22,2011-08-22 19:16:26.421-04,20,27,47
7515,23,2011-08-22 19:16:26.421-04,3,15,18
7516,24,2011-08-22 19:16:26.421-04,1,14,15
7517,25,2011-08-22 19:16:26.421-04,8,7,15
7518,26,2011-08-22 19:16:26.421-04,8,7,15
7519,27,2011-08-22 19:16:26.421-04,5,9,14
7520,30,2011-08-22 19:16:26.421-04,11,4,15
7521,31,2011-08-22 19:16:26.421-04,5,6,11
7522,32,2011-08-22 19:16:26.421-04,9,2,11
7523,33,2011-08-22 19:16:26.421-04,7,12,19
7524,34,2011-08-22 19:16:26.421-04,8,7,15
7525,35,2011-08-22 19:16:26.421-04,0,11,11
7526,36,2011-08-22 19:16:26.421-04,3,12,15
7527,37,2011-08-22 19:16:26.421-04,8,7,15
7528,38,2011-08-22 19:16:26.421-04,29,6,35
7529,39,2011-08-22 19:16:26.421-04,7,12,19
7530,40,2011-08-22 19:16:26.421-04,11,2,13
7531,41,2011-08-22 19:16:26.421-04,17,2,19
7532,42,2011-08-22 19:16:26.421-04,4,15,19
7533,43,2011-08-22 19:16:26.421-04,1,14,15
7534,44,2011-08-22 19:16:26.421-04,16,3,19
7535,45,2011-08-22 19:16:26.421-04,3,16,19
7536,46,2011-08-22 19:16:26.421-04,15,4,19
7537,47,2011-08-22 19:16:26.421-04,11,0,11
7538,48,2011-08-22 19:16:26.421-04,2,13,15
7539,49,2011-08-22 19:16:26.421-04,10,5,15
7540,50,2011-08-22 19:16:26.421-04,0,15,15
7541,51,2011-08-22 19:16:26.421-04,6,9,15
7542,52,2011-08-22 19:16:26.421-04,6,8,14
7543,53,2011-08-22 19:16:26.421-04,11,4,15
7544,55,2011-08-22 19:16:26.421-04,4,11,15
7545,56,2011-08-22 19:16:26.421-04,4,11,15
7546,57,2011-08-22 19:16:26.421-04,3,8,11
7547,3,2011-08-22 19:17:27.445-04,9,8,17
7548,5,2011-08-22 19:17:27.445-04,6,9,15
7549,6,2011-08-22 19:17:27.445-04,14,1,15
7550,8,2011-08-22 19:17:27.445-04,1,14,15
7551,9,2011-08-22 19:17:27.445-04,6,13,19
7552,10,2011-08-22 19:17:27.445-04,4,15,19
7553,11,2011-08-22 19:17:27.445-04,0,15,15
7554,12,2011-08-22 19:17:27.445-04,10,5,15
7555,13,2011-08-22 19:17:27.445-04,7,8,15
7556,14,2011-08-22 19:17:27.445-04,0,17,17
7557,15,2011-08-22 19:17:27.445-04,8,7,15
7558,16,2011-08-22 19:17:27.445-04,9,10,19
7559,17,2011-08-22 19:17:27.445-04,5,10,15
7560,18,2011-08-22 19:17:27.445-04,7,8,15
7561,20,2011-08-22 19:17:27.445-04,13,6,19
7562,21,2011-08-22 19:17:27.445-04,5,18,23
7563,22,2011-08-22 19:17:27.445-04,20,27,47
7564,23,2011-08-22 19:17:27.445-04,3,15,18
7565,24,2011-08-22 19:17:27.445-04,1,14,15
7566,25,2011-08-22 19:17:27.445-04,8,7,15
7567,26,2011-08-22 19:17:27.445-04,8,7,15
7568,27,2011-08-22 19:17:27.445-04,5,9,14
7569,30,2011-08-22 19:17:27.445-04,11,4,15
7570,31,2011-08-22 19:17:27.445-04,5,6,11
7571,32,2011-08-22 19:17:27.445-04,9,2,11
7572,33,2011-08-22 19:17:27.445-04,7,12,19
7573,34,2011-08-22 19:17:27.445-04,8,7,15
7574,35,2011-08-22 19:17:27.445-04,0,11,11
7575,36,2011-08-22 19:17:27.445-04,3,12,15
7576,37,2011-08-22 19:17:27.445-04,8,7,15
7577,38,2011-08-22 19:17:27.445-04,29,6,35
7578,39,2011-08-22 19:17:27.445-04,7,12,19
7579,40,2011-08-22 19:17:27.445-04,11,2,13
7580,41,2011-08-22 19:17:27.445-04,17,2,19
7581,42,2011-08-22 19:17:27.445-04,4,15,19
7582,43,2011-08-22 19:17:27.445-04,1,14,15
7583,44,2011-08-22 19:17:27.445-04,16,3,19
7584,45,2011-08-22 19:17:27.445-04,3,16,19
7585,46,2011-08-22 19:17:27.445-04,15,4,19
7586,47,2011-08-22 19:17:27.445-04,11,0,11
7587,48,2011-08-22 19:17:27.445-04,2,13,15
7588,49,2011-08-22 19:17:27.445-04,10,5,15
7589,50,2011-08-22 19:17:27.445-04,0,15,15
7590,51,2011-08-22 19:17:27.445-04,6,9,15
7591,52,2011-08-22 19:17:27.445-04,8,6,14
7592,53,2011-08-22 19:17:27.445-04,11,4,15
7593,55,2011-08-22 19:17:27.445-04,4,11,15
7594,56,2011-08-22 19:17:27.445-04,4,11,15
7595,57,2011-08-22 19:17:27.445-04,3,8,11
7596,3,2011-08-22 19:18:28.427-04,9,8,17
7597,5,2011-08-22 19:18:28.427-04,6,9,15
7598,6,2011-08-22 19:18:28.427-04,14,1,15
7599,8,2011-08-22 19:18:28.427-04,1,14,15
7600,9,2011-08-22 19:18:28.427-04,6,13,19
7601,10,2011-08-22 19:18:28.427-04,4,15,19
7602,11,2011-08-22 19:18:28.427-04,0,15,15
7603,12,2011-08-22 19:18:28.427-04,10,5,15
7604,13,2011-08-22 19:18:28.427-04,7,8,15
7605,14,2011-08-22 19:18:28.427-04,0,17,17
7606,15,2011-08-22 19:18:28.427-04,8,7,15
7607,16,2011-08-22 19:18:28.427-04,9,10,19
7608,17,2011-08-22 19:18:28.427-04,5,10,15
7609,18,2011-08-22 19:18:28.427-04,7,8,15
7610,20,2011-08-22 19:18:28.427-04,13,6,19
7611,21,2011-08-22 19:18:28.427-04,5,18,23
7612,22,2011-08-22 19:18:28.427-04,20,27,47
7613,23,2011-08-22 19:18:28.427-04,3,15,18
7614,24,2011-08-22 19:18:28.427-04,3,12,15
7615,25,2011-08-22 19:18:28.427-04,8,7,15
7616,26,2011-08-22 19:18:28.427-04,8,7,15
7617,27,2011-08-22 19:18:28.427-04,5,9,14
7618,30,2011-08-22 19:18:28.427-04,11,4,15
7619,31,2011-08-22 19:18:28.427-04,5,6,11
7620,32,2011-08-22 19:18:28.427-04,9,2,11
7621,33,2011-08-22 19:18:28.427-04,7,12,19
7622,34,2011-08-22 19:18:28.427-04,8,7,15
7623,35,2011-08-22 19:18:28.427-04,0,11,11
7624,36,2011-08-22 19:18:28.427-04,3,12,15
7625,37,2011-08-22 19:18:28.427-04,8,7,15
7626,38,2011-08-22 19:18:28.427-04,29,6,35
7627,39,2011-08-22 19:18:28.427-04,7,12,19
7628,40,2011-08-22 19:18:28.427-04,11,2,13
7629,41,2011-08-22 19:18:28.427-04,17,2,19
7630,42,2011-08-22 19:18:28.427-04,4,15,19
7631,43,2011-08-22 19:18:28.427-04,1,14,15
7632,44,2011-08-22 19:18:28.427-04,16,3,19
7633,45,2011-08-22 19:18:28.427-04,3,16,19
7634,46,2011-08-22 19:18:28.427-04,15,4,19
7635,47,2011-08-22 19:18:28.427-04,11,0,11
7636,48,2011-08-22 19:18:28.427-04,2,13,15
7637,49,2011-08-22 19:18:28.427-04,10,5,15
7638,50,2011-08-22 19:18:28.427-04,0,15,15
7639,51,2011-08-22 19:18:28.427-04,6,9,15
7640,52,2011-08-22 19:18:28.427-04,10,4,14
7641,53,2011-08-22 19:18:28.427-04,11,4,15
7642,55,2011-08-22 19:18:28.427-04,4,11,15
7643,56,2011-08-22 19:18:28.427-04,4,11,15
7644,57,2011-08-22 19:18:28.427-04,3,8,11
7645,3,2011-08-22 19:19:29.45-04,9,8,17
7646,5,2011-08-22 19:19:29.45-04,6,9,15
7647,6,2011-08-22 19:19:29.45-04,14,1,15
7648,8,2011-08-22 19:19:29.45-04,1,14,15
7649,9,2011-08-22 19:19:29.45-04,6,13,19
7650,10,2011-08-22 19:19:29.45-04,4,15,19
7651,11,2011-08-22 19:19:29.45-04,0,15,15
7652,12,2011-08-22 19:19:29.45-04,10,5,15
7653,13,2011-08-22 19:19:29.45-04,7,8,15
7654,14,2011-08-22 19:19:29.45-04,0,17,17
7655,15,2011-08-22 19:19:29.45-04,8,7,15
7656,16,2011-08-22 19:19:29.45-04,9,10,19
7657,17,2011-08-22 19:19:29.45-04,5,10,15
7658,18,2011-08-22 19:19:29.45-04,7,8,15
7659,20,2011-08-22 19:19:29.45-04,13,6,19
7660,21,2011-08-22 19:19:29.45-04,5,18,23
7661,22,2011-08-22 19:19:29.45-04,20,27,47
7662,23,2011-08-22 19:19:29.45-04,2,16,18
7663,24,2011-08-22 19:19:29.45-04,3,12,15
7664,25,2011-08-22 19:19:29.45-04,7,8,15
7665,26,2011-08-22 19:19:29.45-04,8,7,15
7666,27,2011-08-22 19:19:29.45-04,5,9,14
7667,30,2011-08-22 19:19:29.45-04,11,4,15
7668,31,2011-08-22 19:19:29.45-04,5,6,11
7669,32,2011-08-22 19:19:29.45-04,9,2,11
7670,33,2011-08-22 19:19:29.45-04,7,12,19
7671,34,2011-08-22 19:19:29.45-04,8,7,15
7672,35,2011-08-22 19:19:29.45-04,0,11,11
7673,36,2011-08-22 19:19:29.45-04,3,12,15
7674,37,2011-08-22 19:19:29.45-04,8,7,15
7675,38,2011-08-22 19:19:29.45-04,29,6,35
7676,39,2011-08-22 19:19:29.45-04,7,12,19
7677,40,2011-08-22 19:19:29.45-04,11,2,13
7678,41,2011-08-22 19:19:29.45-04,17,2,19
7679,42,2011-08-22 19:19:29.45-04,2,17,19
7680,43,2011-08-22 19:19:29.45-04,1,14,15
7681,44,2011-08-22 19:19:29.45-04,16,3,19
7682,45,2011-08-22 19:19:29.45-04,3,16,19
7683,46,2011-08-22 19:19:29.45-04,15,4,19
7684,47,2011-08-22 19:19:29.45-04,11,0,11
7685,48,2011-08-22 19:19:29.45-04,2,13,15
7686,49,2011-08-22 19:19:29.45-04,10,5,15
7687,50,2011-08-22 19:19:29.45-04,0,15,15
7688,51,2011-08-22 19:19:29.45-04,6,9,15
7689,52,2011-08-22 19:19:29.45-04,10,4,14
7690,53,2011-08-22 19:19:29.45-04,11,4,15
7691,55,2011-08-22 19:19:29.45-04,2,13,15
7692,56,2011-08-22 19:19:29.45-04,4,11,15
7693,57,2011-08-22 19:19:29.45-04,3,8,11
7694,3,2011-08-22 19:20:30.374-04,9,8,17
7695,5,2011-08-22 19:20:30.374-04,6,9,15
7696,6,2011-08-22 19:20:30.374-04,14,1,15
7697,8,2011-08-22 19:20:30.374-04,1,14,15
7698,9,2011-08-22 19:20:30.374-04,6,13,19
7699,10,2011-08-22 19:20:30.374-04,4,15,19
7700,11,2011-08-22 19:20:30.374-04,0,15,15
7701,12,2011-08-22 19:20:30.374-04,10,5,15
7702,13,2011-08-22 19:20:30.374-04,7,8,15
7703,14,2011-08-22 19:20:30.374-04,0,17,17
7704,15,2011-08-22 19:20:30.374-04,8,7,15
7705,16,2011-08-22 19:20:30.374-04,9,10,19
7706,17,2011-08-22 19:20:30.374-04,5,10,15
7707,18,2011-08-22 19:20:30.374-04,7,8,15
7708,20,2011-08-22 19:20:30.374-04,13,6,19
7709,21,2011-08-22 19:20:30.374-04,5,18,23
7710,22,2011-08-22 19:20:30.374-04,20,27,47
7711,23,2011-08-22 19:20:30.374-04,2,16,18
7712,24,2011-08-22 19:20:30.374-04,3,12,15
7713,25,2011-08-22 19:20:30.374-04,6,9,15
7714,26,2011-08-22 19:20:30.374-04,8,7,15
7715,27,2011-08-22 19:20:30.374-04,5,9,14
7716,30,2011-08-22 19:20:30.374-04,11,4,15
7717,31,2011-08-22 19:20:30.374-04,5,6,11
7718,32,2011-08-22 19:20:30.374-04,10,1,11
7719,33,2011-08-22 19:20:30.374-04,7,12,19
7720,34,2011-08-22 19:20:30.374-04,8,7,15
7721,35,2011-08-22 19:20:30.374-04,0,11,11
7722,36,2011-08-22 19:20:30.374-04,3,12,15
7723,37,2011-08-22 19:20:30.374-04,8,7,15
7724,38,2011-08-22 19:20:30.374-04,29,6,35
7725,39,2011-08-22 19:20:30.374-04,7,12,19
7726,40,2011-08-22 19:20:30.374-04,11,2,13
7727,41,2011-08-22 19:20:30.374-04,17,2,19
7728,42,2011-08-22 19:20:30.374-04,1,18,19
7729,43,2011-08-22 19:20:30.374-04,2,13,15
7730,44,2011-08-22 19:20:30.374-04,16,3,19
7731,45,2011-08-22 19:20:30.374-04,3,16,19
7732,46,2011-08-22 19:20:30.374-04,15,4,19
7733,47,2011-08-22 19:20:30.374-04,11,0,11
7734,48,2011-08-22 19:20:30.374-04,2,13,15
7735,49,2011-08-22 19:20:30.374-04,10,5,15
7736,50,2011-08-22 19:20:30.374-04,0,15,15
7737,51,2011-08-22 19:20:30.374-04,6,9,15
7738,52,2011-08-22 19:20:30.374-04,10,4,14
7739,53,2011-08-22 19:20:30.374-04,10,5,15
7740,55,2011-08-22 19:20:30.374-04,2,13,15
7741,56,2011-08-22 19:20:30.374-04,4,11,15
7742,57,2011-08-22 19:20:30.374-04,3,8,11
7743,3,2011-08-22 19:21:31.337-04,9,8,17
7744,5,2011-08-22 19:21:31.337-04,6,9,15
7745,6,2011-08-22 19:21:31.337-04,13,2,15
7746,8,2011-08-22 19:21:31.337-04,1,14,15
7747,9,2011-08-22 19:21:31.337-04,6,13,19
7748,10,2011-08-22 19:21:31.337-04,4,15,19
7749,11,2011-08-22 19:21:31.337-04,0,15,15
7750,12,2011-08-22 19:21:31.337-04,10,5,15
7751,13,2011-08-22 19:21:31.337-04,7,8,15
7752,14,2011-08-22 19:21:31.337-04,0,17,17
7753,15,2011-08-22 19:21:31.337-04,7,8,15
7754,16,2011-08-22 19:21:31.337-04,9,10,19
7755,17,2011-08-22 19:21:31.337-04,5,10,15
7756,18,2011-08-22 19:21:31.337-04,7,8,15
7757,20,2011-08-22 19:21:31.337-04,13,6,19
7758,21,2011-08-22 19:21:31.337-04,5,18,23
7759,22,2011-08-22 19:21:31.337-04,20,27,47
7760,23,2011-08-22 19:21:31.337-04,1,17,18
7761,24,2011-08-22 19:21:31.337-04,3,12,15
7762,25,2011-08-22 19:21:31.337-04,6,9,15
7763,26,2011-08-22 19:21:31.337-04,8,7,15
7764,27,2011-08-22 19:21:31.337-04,5,9,14
7765,30,2011-08-22 19:21:31.337-04,11,4,15
7766,31,2011-08-22 19:21:31.337-04,5,6,11
7767,32,2011-08-22 19:21:31.337-04,10,1,11
7768,33,2011-08-22 19:21:31.337-04,7,12,19
7769,34,2011-08-22 19:21:31.337-04,8,7,15
7770,35,2011-08-22 19:21:31.337-04,0,11,11
7771,36,2011-08-22 19:21:31.337-04,3,12,15
7772,37,2011-08-22 19:21:31.337-04,8,7,15
7773,38,2011-08-22 19:21:31.337-04,29,6,35
7774,39,2011-08-22 19:21:31.337-04,7,12,19
7775,40,2011-08-22 19:21:31.337-04,12,1,13
7776,41,2011-08-22 19:21:31.337-04,16,3,19
7777,42,2011-08-22 19:21:31.337-04,1,18,19
7778,43,2011-08-22 19:21:31.337-04,2,13,15
7779,44,2011-08-22 19:21:31.337-04,15,4,19
7780,45,2011-08-22 19:21:31.337-04,3,16,19
7781,46,2011-08-22 19:21:31.337-04,15,4,19
7782,47,2011-08-22 19:21:31.337-04,11,0,11
7783,48,2011-08-22 19:21:31.337-04,2,13,15
7784,49,2011-08-22 19:21:31.337-04,10,5,15
7785,50,2011-08-22 19:21:31.337-04,0,15,15
7786,51,2011-08-22 19:21:31.337-04,6,9,15
7787,52,2011-08-22 19:21:31.337-04,11,3,14
7788,53,2011-08-22 19:21:31.337-04,9,6,15
7789,55,2011-08-22 19:21:31.337-04,2,13,15
7790,56,2011-08-22 19:21:31.337-04,4,11,15
7791,57,2011-08-22 19:21:31.337-04,3,8,11
7792,3,2011-08-22 19:22:32.267-04,9,8,17
7793,5,2011-08-22 19:22:32.267-04,6,9,15
7794,6,2011-08-22 19:22:32.267-04,13,2,15
7795,8,2011-08-22 19:22:32.267-04,1,14,15
7796,9,2011-08-22 19:22:32.267-04,6,13,19
7797,10,2011-08-22 19:22:32.267-04,4,15,19
7798,11,2011-08-22 19:22:32.267-04,0,15,15
7799,12,2011-08-22 19:22:32.267-04,10,5,15
7800,13,2011-08-22 19:22:32.267-04,7,8,15
7801,14,2011-08-22 19:22:32.267-04,0,17,17
7802,15,2011-08-22 19:22:32.267-04,5,10,15
7803,16,2011-08-22 19:22:32.267-04,9,10,19
7804,17,2011-08-22 19:22:32.267-04,5,10,15
7805,18,2011-08-22 19:22:32.267-04,6,9,15
7806,20,2011-08-22 19:22:32.267-04,14,5,19
7807,21,2011-08-22 19:22:32.267-04,5,18,23
7808,22,2011-08-22 19:22:32.267-04,20,27,47
7809,23,2011-08-22 19:22:32.267-04,1,17,18
7810,24,2011-08-22 19:22:32.267-04,3,12,15
7811,25,2011-08-22 19:22:32.267-04,6,9,15
7812,26,2011-08-22 19:22:32.267-04,8,7,15
7813,27,2011-08-22 19:22:32.267-04,5,9,14
7814,30,2011-08-22 19:22:32.267-04,11,4,15
7815,31,2011-08-22 19:22:32.267-04,5,6,11
7816,32,2011-08-22 19:22:32.267-04,10,1,11
7817,33,2011-08-22 19:22:32.267-04,7,12,19
7818,34,2011-08-22 19:22:32.267-04,8,7,15
7819,35,2011-08-22 19:22:32.267-04,0,11,11
7820,36,2011-08-22 19:22:32.267-04,3,12,15
7821,37,2011-08-22 19:22:32.267-04,8,7,15
7822,38,2011-08-22 19:22:32.267-04,30,5,35
7823,39,2011-08-22 19:22:32.267-04,7,12,19
7824,40,2011-08-22 19:22:32.267-04,12,1,13
7825,41,2011-08-22 19:22:32.267-04,17,2,19
7826,42,2011-08-22 19:22:32.267-04,1,18,19
7827,43,2011-08-22 19:22:32.267-04,2,13,15
7828,44,2011-08-22 19:22:32.267-04,15,4,19
7829,45,2011-08-22 19:22:32.267-04,3,16,19
7830,46,2011-08-22 19:22:32.267-04,14,5,19
7831,47,2011-08-22 19:22:32.267-04,11,0,11
7832,48,2011-08-22 19:22:32.267-04,2,13,15
7833,49,2011-08-22 19:22:32.267-04,10,5,15
7834,50,2011-08-22 19:22:32.267-04,0,15,15
7835,51,2011-08-22 19:22:32.267-04,6,9,15
7836,52,2011-08-22 19:22:32.267-04,12,2,14
7837,53,2011-08-22 19:22:32.267-04,9,6,15
7838,55,2011-08-22 19:22:32.267-04,2,13,15
7839,56,2011-08-22 19:22:32.267-04,4,11,15
7840,57,2011-08-22 19:22:32.267-04,3,8,11
7841,3,2011-08-22 19:23:33.26-04,9,8,17
7842,5,2011-08-22 19:23:33.26-04,6,9,15
7843,6,2011-08-22 19:23:33.26-04,13,2,15
7844,8,2011-08-22 19:23:33.26-04,1,14,15
7845,9,2011-08-22 19:23:33.26-04,6,13,19
7846,10,2011-08-22 19:23:33.26-04,4,15,19
7847,11,2011-08-22 19:23:33.26-04,0,15,15
7848,12,2011-08-22 19:23:33.26-04,10,5,15
7849,13,2011-08-22 19:23:33.26-04,7,8,15
7850,14,2011-08-22 19:23:33.26-04,0,17,17
7851,15,2011-08-22 19:23:33.26-04,5,10,15
7852,16,2011-08-22 19:23:33.26-04,9,10,19
7853,17,2011-08-22 19:23:33.26-04,5,10,15
7854,18,2011-08-22 19:23:33.26-04,6,9,15
7855,20,2011-08-22 19:23:33.26-04,15,4,19
7856,21,2011-08-22 19:23:33.26-04,5,18,23
7857,22,2011-08-22 19:23:33.26-04,19,28,47
7858,23,2011-08-22 19:23:33.26-04,1,17,18
7859,24,2011-08-22 19:23:33.26-04,3,12,15
7860,25,2011-08-22 19:23:33.26-04,6,9,15
7861,26,2011-08-22 19:23:33.26-04,8,7,15
7862,27,2011-08-22 19:23:33.26-04,5,9,14
7863,30,2011-08-22 19:23:33.26-04,11,4,15
7864,31,2011-08-22 19:23:33.26-04,5,6,11
7865,32,2011-08-22 19:23:33.26-04,10,1,11
7866,33,2011-08-22 19:23:33.26-04,7,12,19
7867,34,2011-08-22 19:23:33.26-04,8,7,15
7868,35,2011-08-22 19:23:33.26-04,0,11,11
7869,36,2011-08-22 19:23:33.26-04,3,12,15
7870,37,2011-08-22 19:23:33.26-04,8,7,15
7871,38,2011-08-22 19:23:33.26-04,30,5,35
7872,39,2011-08-22 19:23:33.26-04,7,12,19
7873,40,2011-08-22 19:23:33.26-04,12,1,13
7874,41,2011-08-22 19:23:33.26-04,18,1,19
7875,42,2011-08-22 19:23:33.26-04,1,18,19
7876,43,2011-08-22 19:23:33.26-04,2,13,15
7877,44,2011-08-22 19:23:33.26-04,15,4,19
7878,45,2011-08-22 19:23:33.26-04,3,16,19
7879,46,2011-08-22 19:23:33.26-04,13,6,19
7880,47,2011-08-22 19:23:33.26-04,11,0,11
7881,48,2011-08-22 19:23:33.26-04,2,13,15
7882,49,2011-08-22 19:23:33.26-04,10,5,15
7883,50,2011-08-22 19:23:33.26-04,0,15,15
7884,51,2011-08-22 19:23:33.26-04,6,9,15
7885,52,2011-08-22 19:23:33.26-04,12,2,14
7886,53,2011-08-22 19:23:33.26-04,9,6,15
7887,55,2011-08-22 19:23:33.26-04,2,13,15
7888,56,2011-08-22 19:23:33.26-04,4,11,15
7889,57,2011-08-22 19:23:33.26-04,3,8,11
7890,3,2011-08-22 19:24:34.229-04,9,8,17
7891,5,2011-08-22 19:24:34.229-04,6,9,15
7892,6,2011-08-22 19:24:34.229-04,13,2,15
7893,8,2011-08-22 19:24:34.229-04,1,14,15
7894,9,2011-08-22 19:24:34.229-04,6,13,19
7895,10,2011-08-22 19:24:34.229-04,4,15,19
7896,11,2011-08-22 19:24:34.229-04,0,15,15
7897,12,2011-08-22 19:24:34.229-04,10,5,15
7898,13,2011-08-22 19:24:34.229-04,7,8,15
7899,14,2011-08-22 19:24:34.229-04,0,17,17
7900,15,2011-08-22 19:24:34.229-04,5,10,15
7901,16,2011-08-22 19:24:34.229-04,9,10,19
7902,17,2011-08-22 19:24:34.229-04,5,10,15
7903,18,2011-08-22 19:24:34.229-04,6,9,15
7904,20,2011-08-22 19:24:34.229-04,15,4,19
7905,21,2011-08-22 19:24:34.229-04,5,18,23
7906,22,2011-08-22 19:24:34.229-04,20,27,47
7907,23,2011-08-22 19:24:34.229-04,1,17,18
7908,24,2011-08-22 19:24:34.229-04,3,12,15
7909,25,2011-08-22 19:24:34.229-04,6,9,15
7910,26,2011-08-22 19:24:34.229-04,8,7,15
7911,27,2011-08-22 19:24:34.229-04,5,9,14
7912,30,2011-08-22 19:24:34.229-04,11,4,15
7913,31,2011-08-22 19:24:34.229-04,4,7,11
7914,32,2011-08-22 19:24:34.229-04,10,1,11
7915,33,2011-08-22 19:24:34.229-04,7,12,19
7916,34,2011-08-22 19:24:34.229-04,8,7,15
7917,35,2011-08-22 19:24:34.229-04,0,11,11
7918,36,2011-08-22 19:24:34.229-04,3,12,15
7919,37,2011-08-22 19:24:34.229-04,8,7,15
7920,38,2011-08-22 19:24:34.229-04,30,5,35
7921,39,2011-08-22 19:24:34.229-04,7,12,19
7922,40,2011-08-22 19:24:34.229-04,12,1,13
7923,41,2011-08-22 19:24:34.229-04,18,1,19
7924,42,2011-08-22 19:24:34.229-04,1,18,19
7925,43,2011-08-22 19:24:34.229-04,2,13,15
7926,44,2011-08-22 19:24:34.229-04,15,4,19
7927,45,2011-08-22 19:24:34.229-04,3,16,19
7928,46,2011-08-22 19:24:34.229-04,12,7,19
7929,47,2011-08-22 19:24:34.229-04,11,0,11
7930,48,2011-08-22 19:24:34.229-04,2,13,15
7931,49,2011-08-22 19:24:34.229-04,10,5,15
7932,50,2011-08-22 19:24:34.229-04,0,15,15
7933,51,2011-08-22 19:24:34.229-04,6,9,15
7934,52,2011-08-22 19:24:34.229-04,12,2,14
7935,53,2011-08-22 19:24:34.229-04,9,6,15
7936,55,2011-08-22 19:24:34.229-04,2,13,15
7937,56,2011-08-22 19:24:34.229-04,4,11,15
7938,57,2011-08-22 19:24:34.229-04,3,8,11
7939,3,2011-08-22 19:25:35.198-04,9,8,17
7940,5,2011-08-22 19:25:35.198-04,6,9,15
7941,6,2011-08-22 19:25:35.198-04,13,2,15
7942,8,2011-08-22 19:25:35.198-04,1,14,15
7943,9,2011-08-22 19:25:35.198-04,6,13,19
7944,10,2011-08-22 19:25:35.198-04,4,15,19
7945,11,2011-08-22 19:25:35.198-04,0,15,15
7946,12,2011-08-22 19:25:35.198-04,10,5,15
7947,13,2011-08-22 19:25:35.198-04,7,8,15
7948,14,2011-08-22 19:25:35.198-04,0,17,17
7949,15,2011-08-22 19:25:35.198-04,5,10,15
7950,16,2011-08-22 19:25:35.198-04,9,10,19
7951,17,2011-08-22 19:25:35.198-04,5,10,15
7952,18,2011-08-22 19:25:35.198-04,6,9,15
7953,20,2011-08-22 19:25:35.198-04,15,4,19
7954,21,2011-08-22 19:25:35.198-04,5,18,23
7955,22,2011-08-22 19:25:35.198-04,20,27,47
7956,23,2011-08-22 19:25:35.198-04,1,17,18
7957,24,2011-08-22 19:25:35.198-04,3,12,15
7958,25,2011-08-22 19:25:35.198-04,6,9,15
7959,26,2011-08-22 19:25:35.198-04,8,7,15
7960,27,2011-08-22 19:25:35.198-04,5,9,14
7961,30,2011-08-22 19:25:35.198-04,11,4,15
7962,31,2011-08-22 19:25:35.198-04,4,7,11
7963,32,2011-08-22 19:25:35.198-04,10,1,11
7964,33,2011-08-22 19:25:35.198-04,7,12,19
7965,34,2011-08-22 19:25:35.198-04,8,7,15
7966,35,2011-08-22 19:25:35.198-04,0,11,11
7967,36,2011-08-22 19:25:35.198-04,3,12,15
7968,37,2011-08-22 19:25:35.198-04,8,7,15
7969,38,2011-08-22 19:25:35.198-04,30,5,35
7970,39,2011-08-22 19:25:35.198-04,7,12,19
7971,40,2011-08-22 19:25:35.198-04,12,1,13
7972,41,2011-08-22 19:25:35.198-04,18,1,19
7973,42,2011-08-22 19:25:35.198-04,1,18,19
7974,43,2011-08-22 19:25:35.198-04,2,13,15
7975,44,2011-08-22 19:25:35.198-04,15,4,19
7976,45,2011-08-22 19:25:35.198-04,3,16,19
7977,46,2011-08-22 19:25:35.198-04,12,7,19
7978,47,2011-08-22 19:25:35.198-04,11,0,11
7979,48,2011-08-22 19:25:35.198-04,2,13,15
7980,49,2011-08-22 19:25:35.198-04,10,5,15
7981,50,2011-08-22 19:25:35.198-04,0,15,15
7982,51,2011-08-22 19:25:35.198-04,6,9,15
7983,52,2011-08-22 19:25:35.198-04,13,1,14
7984,53,2011-08-22 19:25:35.198-04,10,5,15
7985,55,2011-08-22 19:25:35.198-04,2,13,15
7986,56,2011-08-22 19:25:35.198-04,4,11,15
7987,57,2011-08-22 19:25:35.198-04,3,8,11
7988,3,2011-08-22 19:26:36.19-04,9,8,17
7989,5,2011-08-22 19:26:36.19-04,6,9,15
7990,6,2011-08-22 19:26:36.19-04,13,2,15
7991,8,2011-08-22 19:26:36.19-04,1,14,15
7992,9,2011-08-22 19:26:36.19-04,6,13,19
7993,10,2011-08-22 19:26:36.19-04,4,15,19
7994,11,2011-08-22 19:26:36.19-04,0,15,15
7995,12,2011-08-22 19:26:36.19-04,10,5,15
7996,13,2011-08-22 19:26:36.19-04,7,8,15
7997,14,2011-08-22 19:26:36.19-04,0,17,17
7998,15,2011-08-22 19:26:36.19-04,5,10,15
7999,16,2011-08-22 19:26:36.19-04,9,10,19
8000,17,2011-08-22 19:26:36.19-04,5,10,15
8001,18,2011-08-22 19:26:36.19-04,6,9,15
8002,20,2011-08-22 19:26:36.19-04,15,4,19
8003,21,2011-08-22 19:26:36.19-04,5,18,23
8004,22,2011-08-22 19:26:36.19-04,19,28,47
8005,23,2011-08-22 19:26:36.19-04,1,17,18
8006,24,2011-08-22 19:26:36.19-04,3,12,15
8007,25,2011-08-22 19:26:36.19-04,6,9,15
8008,26,2011-08-22 19:26:36.19-04,8,7,15
8009,27,2011-08-22 19:26:36.19-04,5,9,14
8010,30,2011-08-22 19:26:36.19-04,11,4,15
8011,31,2011-08-22 19:26:36.19-04,4,7,11
8012,32,2011-08-22 19:26:36.19-04,10,1,11
8013,33,2011-08-22 19:26:36.19-04,7,12,19
8014,34,2011-08-22 19:26:36.19-04,8,7,15
8015,35,2011-08-22 19:26:36.19-04,0,11,11
8016,36,2011-08-22 19:26:36.19-04,3,12,15
8017,37,2011-08-22 19:26:36.19-04,8,7,15
8018,38,2011-08-22 19:26:36.19-04,30,5,35
8019,39,2011-08-22 19:26:36.19-04,7,12,19
8020,40,2011-08-22 19:26:36.19-04,12,1,13
8021,41,2011-08-22 19:26:36.19-04,18,1,19
8022,42,2011-08-22 19:26:36.19-04,1,18,19
8023,43,2011-08-22 19:26:36.19-04,2,13,15
8024,44,2011-08-22 19:26:36.19-04,14,5,19
8025,45,2011-08-22 19:26:36.19-04,3,16,19
8026,46,2011-08-22 19:26:36.19-04,10,9,19
8027,47,2011-08-22 19:26:36.19-04,11,0,11
8028,48,2011-08-22 19:26:36.19-04,2,13,15
8029,49,2011-08-22 19:26:36.19-04,10,5,15
8030,50,2011-08-22 19:26:36.19-04,0,15,15
8031,51,2011-08-22 19:26:36.19-04,6,9,15
8032,52,2011-08-22 19:26:36.19-04,14,0,14
8033,53,2011-08-22 19:26:36.19-04,10,5,15
8034,55,2011-08-22 19:26:36.19-04,2,13,15
8035,56,2011-08-22 19:26:36.19-04,4,11,15
8036,57,2011-08-22 19:26:36.19-04,3,8,11
8037,3,2011-08-22 19:27:37.215-04,9,8,17
8038,5,2011-08-22 19:27:37.215-04,6,9,15
8039,6,2011-08-22 19:27:37.215-04,13,2,15
8040,8,2011-08-22 19:27:37.215-04,1,14,15
8041,9,2011-08-22 19:27:37.215-04,6,13,19
8042,10,2011-08-22 19:27:37.215-04,4,15,19
8043,11,2011-08-22 19:27:37.215-04,0,15,15
8044,12,2011-08-22 19:27:37.215-04,10,5,15
8045,13,2011-08-22 19:27:37.215-04,7,8,15
8046,14,2011-08-22 19:27:37.215-04,0,17,17
8047,15,2011-08-22 19:27:37.215-04,5,10,15
8048,16,2011-08-22 19:27:37.215-04,9,10,19
8049,17,2011-08-22 19:27:37.215-04,5,10,15
8050,18,2011-08-22 19:27:37.215-04,6,9,15
8051,20,2011-08-22 19:27:37.215-04,15,4,19
8052,21,2011-08-22 19:27:37.215-04,5,18,23
8053,22,2011-08-22 19:27:37.215-04,19,28,47
8054,23,2011-08-22 19:27:37.215-04,1,17,18
8055,24,2011-08-22 19:27:37.215-04,3,12,15
8056,25,2011-08-22 19:27:37.215-04,6,9,15
8057,26,2011-08-22 19:27:37.215-04,8,7,15
8058,27,2011-08-22 19:27:37.215-04,5,9,14
8059,30,2011-08-22 19:27:37.215-04,11,4,15
8060,31,2011-08-22 19:27:37.215-04,4,7,11
8061,32,2011-08-22 19:27:37.215-04,10,1,11
8062,33,2011-08-22 19:27:37.215-04,7,12,19
8063,34,2011-08-22 19:27:37.215-04,8,7,15
8064,35,2011-08-22 19:27:37.215-04,0,11,11
8065,36,2011-08-22 19:27:37.215-04,3,12,15
8066,37,2011-08-22 19:27:37.215-04,8,7,15
8067,38,2011-08-22 19:27:37.215-04,31,4,35
8068,39,2011-08-22 19:27:37.215-04,9,10,19
8069,40,2011-08-22 19:27:37.215-04,12,1,13
8070,41,2011-08-22 19:27:37.215-04,18,1,19
8071,42,2011-08-22 19:27:37.215-04,1,18,19
8072,43,2011-08-22 19:27:37.215-04,2,13,15
8073,44,2011-08-22 19:27:37.215-04,14,5,19
8074,45,2011-08-22 19:27:37.215-04,3,16,19
8075,46,2011-08-22 19:27:37.215-04,10,9,19
8076,47,2011-08-22 19:27:37.215-04,11,0,11
8077,48,2011-08-22 19:27:37.215-04,2,13,15
8078,49,2011-08-22 19:27:37.215-04,10,5,15
8079,50,2011-08-22 19:27:37.215-04,0,15,15
8080,51,2011-08-22 19:27:37.215-04,6,9,15
8081,52,2011-08-22 19:27:37.215-04,13,1,14
8082,53,2011-08-22 19:27:37.215-04,10,5,15
8083,55,2011-08-22 19:27:37.215-04,2,13,15
8084,56,2011-08-22 19:27:37.215-04,4,11,15
8085,57,2011-08-22 19:27:37.215-04,3,8,11
8086,3,2011-08-22 19:28:38.114-04,9,8,17
8087,5,2011-08-22 19:28:38.114-04,6,9,15
8088,6,2011-08-22 19:28:38.114-04,13,2,15
8089,8,2011-08-22 19:28:38.114-04,2,13,15
8090,9,2011-08-22 19:28:38.114-04,7,12,19
8091,10,2011-08-22 19:28:38.114-04,4,15,19
8092,11,2011-08-22 19:28:38.114-04,0,15,15
8093,12,2011-08-22 19:28:38.114-04,10,5,15
8094,13,2011-08-22 19:28:38.114-04,7,8,15
8095,14,2011-08-22 19:28:38.114-04,0,17,17
8096,15,2011-08-22 19:28:38.114-04,5,10,15
8097,16,2011-08-22 19:28:38.114-04,9,10,19
8098,17,2011-08-22 19:28:38.114-04,5,10,15
8099,18,2011-08-22 19:28:38.114-04,6,9,15
8100,20,2011-08-22 19:28:38.114-04,15,4,19
8101,21,2011-08-22 19:28:38.114-04,5,18,23
8102,22,2011-08-22 19:28:38.114-04,20,27,47
8103,23,2011-08-22 19:28:38.114-04,1,17,18
8104,24,2011-08-22 19:28:38.114-04,3,12,15
8105,25,2011-08-22 19:28:38.114-04,6,9,15
8106,26,2011-08-22 19:28:38.114-04,8,7,15
8107,27,2011-08-22 19:28:38.114-04,5,9,14
8108,30,2011-08-22 19:28:38.114-04,11,4,15
8109,31,2011-08-22 19:28:38.114-04,4,7,11
8110,32,2011-08-22 19:28:38.114-04,10,1,11
8111,33,2011-08-22 19:28:38.114-04,7,12,19
8112,34,2011-08-22 19:28:38.114-04,8,7,15
8113,35,2011-08-22 19:28:38.114-04,0,11,11
8114,36,2011-08-22 19:28:38.114-04,3,12,15
8115,37,2011-08-22 19:28:38.114-04,8,7,15
8116,38,2011-08-22 19:28:38.114-04,31,4,35
8117,39,2011-08-22 19:28:38.114-04,9,10,19
8118,40,2011-08-22 19:28:38.114-04,12,1,13
8119,41,2011-08-22 19:28:38.114-04,18,1,19
8120,42,2011-08-22 19:28:38.114-04,1,18,19
8121,43,2011-08-22 19:28:38.114-04,2,13,15
8122,44,2011-08-22 19:28:38.114-04,14,5,19
8123,45,2011-08-22 19:28:38.114-04,3,16,19
8124,46,2011-08-22 19:28:38.114-04,10,9,19
8125,47,2011-08-22 19:28:38.114-04,11,0,11
8126,48,2011-08-22 19:28:38.114-04,1,14,15
8127,49,2011-08-22 19:28:38.114-04,10,5,15
8128,50,2011-08-22 19:28:38.114-04,0,15,15
8129,51,2011-08-22 19:28:38.114-04,6,9,15
8130,52,2011-08-22 19:28:38.114-04,13,1,14
8131,53,2011-08-22 19:28:38.114-04,11,4,15
8132,55,2011-08-22 19:28:38.114-04,3,12,15
8133,56,2011-08-22 19:28:38.114-04,4,11,15
8134,57,2011-08-22 19:28:38.114-04,3,8,11
8135,3,2011-08-22 19:29:39.115-04,9,8,17
8136,5,2011-08-22 19:29:39.115-04,6,9,15
8137,6,2011-08-22 19:29:39.115-04,13,2,15
8138,8,2011-08-22 19:29:39.115-04,2,13,15
8139,9,2011-08-22 19:29:39.115-04,9,10,19
8140,10,2011-08-22 19:29:39.115-04,5,14,19
8141,11,2011-08-22 19:29:39.115-04,0,15,15
8142,12,2011-08-22 19:29:39.115-04,10,5,15
8143,13,2011-08-22 19:29:39.115-04,7,8,15
8144,14,2011-08-22 19:29:39.115-04,0,17,17
8145,15,2011-08-22 19:29:39.115-04,5,10,15
8146,16,2011-08-22 19:29:39.115-04,9,10,19
8147,17,2011-08-22 19:29:39.115-04,5,10,15
8148,18,2011-08-22 19:29:39.115-04,6,9,15
8149,20,2011-08-22 19:29:39.115-04,15,4,19
8150,21,2011-08-22 19:29:39.115-04,5,18,23
8151,22,2011-08-22 19:29:39.115-04,20,27,47
8152,23,2011-08-22 19:29:39.115-04,3,15,18
8153,24,2011-08-22 19:29:39.115-04,3,12,15
8154,25,2011-08-22 19:29:39.115-04,6,9,15
8155,26,2011-08-22 19:29:39.115-04,8,7,15
8156,27,2011-08-22 19:29:39.115-04,5,9,14
8157,30,2011-08-22 19:29:39.115-04,11,4,15
8158,31,2011-08-22 19:29:39.115-04,4,7,11
8159,32,2011-08-22 19:29:39.115-04,10,1,11
8160,33,2011-08-22 19:29:39.115-04,7,12,19
8161,34,2011-08-22 19:29:39.115-04,8,7,15
8162,35,2011-08-22 19:29:39.115-04,0,11,11
8163,36,2011-08-22 19:29:39.115-04,3,12,15
8164,37,2011-08-22 19:29:39.115-04,8,7,15
8165,38,2011-08-22 19:29:39.115-04,32,3,35
8166,39,2011-08-22 19:29:39.115-04,9,10,19
8167,40,2011-08-22 19:29:39.115-04,12,1,13
8168,41,2011-08-22 19:29:39.115-04,18,1,19
8169,42,2011-08-22 19:29:39.115-04,1,18,19
8170,43,2011-08-22 19:29:39.115-04,2,13,15
8171,44,2011-08-22 19:29:39.115-04,14,5,19
8172,45,2011-08-22 19:29:39.115-04,3,16,19
8173,46,2011-08-22 19:29:39.115-04,10,9,19
8174,47,2011-08-22 19:29:39.115-04,11,0,11
8175,48,2011-08-22 19:29:39.115-04,1,14,15
8176,49,2011-08-22 19:29:39.115-04,10,5,15
8177,50,2011-08-22 19:29:39.115-04,0,15,15
8178,51,2011-08-22 19:29:39.115-04,6,9,15
8179,52,2011-08-22 19:29:39.115-04,13,1,14
8180,53,2011-08-22 19:29:39.115-04,13,2,15
8181,55,2011-08-22 19:29:39.115-04,3,12,15
8182,56,2011-08-22 19:29:39.115-04,4,11,15
8183,57,2011-08-22 19:29:39.115-04,3,8,11
8184,3,2011-08-22 19:30:40.118-04,9,8,17
8185,5,2011-08-22 19:30:40.118-04,6,9,15
8186,6,2011-08-22 19:30:40.118-04,13,2,15
8187,8,2011-08-22 19:30:40.118-04,2,13,15
8188,9,2011-08-22 19:30:40.118-04,10,9,19
8189,10,2011-08-22 19:30:40.118-04,5,14,19
8190,11,2011-08-22 19:30:40.118-04,0,15,15
8191,12,2011-08-22 19:30:40.118-04,10,5,15
8192,13,2011-08-22 19:30:40.118-04,7,8,15
8193,14,2011-08-22 19:30:40.118-04,0,17,17
8194,15,2011-08-22 19:30:40.118-04,5,10,15
8195,16,2011-08-22 19:30:40.118-04,9,10,19
8196,17,2011-08-22 19:30:40.118-04,5,10,15
8197,18,2011-08-22 19:30:40.118-04,6,9,15
8198,20,2011-08-22 19:30:40.118-04,15,4,19
8199,21,2011-08-22 19:30:40.118-04,5,18,23
8200,22,2011-08-22 19:30:40.118-04,20,27,47
8201,23,2011-08-22 19:30:40.118-04,3,15,18
8202,24,2011-08-22 19:30:40.118-04,2,13,15
8203,25,2011-08-22 19:30:40.118-04,6,9,15
8204,26,2011-08-22 19:30:40.118-04,8,7,15
8205,27,2011-08-22 19:30:40.118-04,5,9,14
8206,30,2011-08-22 19:30:40.118-04,11,4,15
8207,31,2011-08-22 19:30:40.118-04,4,7,11
8208,32,2011-08-22 19:30:40.118-04,10,1,11
8209,33,2011-08-22 19:30:40.118-04,7,12,19
8210,34,2011-08-22 19:30:40.118-04,8,7,15
8211,35,2011-08-22 19:30:40.118-04,0,11,11
8212,36,2011-08-22 19:30:40.118-04,3,12,15
8213,37,2011-08-22 19:30:40.118-04,8,7,15
8214,38,2011-08-22 19:30:40.118-04,32,3,35
8215,39,2011-08-22 19:30:40.118-04,9,10,19
8216,40,2011-08-22 19:30:40.118-04,12,1,13
8217,41,2011-08-22 19:30:40.118-04,19,0,19
8218,42,2011-08-22 19:30:40.118-04,1,18,19
8219,43,2011-08-22 19:30:40.118-04,2,13,15
8220,44,2011-08-22 19:30:40.118-04,14,5,19
8221,45,2011-08-22 19:30:40.118-04,3,16,19
8222,46,2011-08-22 19:30:40.118-04,10,9,19
8223,47,2011-08-22 19:30:40.118-04,11,0,11
8224,48,2011-08-22 19:30:40.118-04,1,14,15
8225,49,2011-08-22 19:30:40.118-04,10,5,15
8226,50,2011-08-22 19:30:40.118-04,0,15,15
8227,51,2011-08-22 19:30:40.118-04,6,9,15
8228,52,2011-08-22 19:30:40.118-04,13,1,14
8229,53,2011-08-22 19:30:40.118-04,13,2,15
8230,55,2011-08-22 19:30:40.118-04,7,8,15
8231,56,2011-08-22 19:30:40.118-04,4,11,15
8232,57,2011-08-22 19:30:40.118-04,3,8,11
8233,3,2011-08-22 19:31:41.094-04,9,8,17
8234,5,2011-08-22 19:31:41.094-04,6,9,15
8235,6,2011-08-22 19:31:41.094-04,13,2,15
8236,8,2011-08-22 19:31:41.094-04,2,13,15
8237,9,2011-08-22 19:31:41.094-04,11,8,19
8238,10,2011-08-22 19:31:41.094-04,5,14,19
8239,11,2011-08-22 19:31:41.094-04,0,15,15
8240,12,2011-08-22 19:31:41.094-04,10,5,15
8241,13,2011-08-22 19:31:41.094-04,7,8,15
8242,14,2011-08-22 19:31:41.094-04,0,17,17
8243,15,2011-08-22 19:31:41.094-04,5,10,15
8244,16,2011-08-22 19:31:41.094-04,9,10,19
8245,17,2011-08-22 19:31:41.094-04,5,10,15
8246,18,2011-08-22 19:31:41.094-04,6,9,15
8247,20,2011-08-22 19:31:41.094-04,15,4,19
8248,21,2011-08-22 19:31:41.094-04,5,18,23
8249,22,2011-08-22 19:31:41.094-04,20,27,47
8250,23,2011-08-22 19:31:41.094-04,3,15,18
8251,24,2011-08-22 19:31:41.094-04,2,13,15
8252,25,2011-08-22 19:31:41.094-04,6,9,15
8253,26,2011-08-22 19:31:41.094-04,8,7,15
8254,27,2011-08-22 19:31:41.094-04,5,9,14
8255,30,2011-08-22 19:31:41.094-04,11,4,15
8256,31,2011-08-22 19:31:41.094-04,4,7,11
8257,32,2011-08-22 19:31:41.094-04,10,1,11
8258,33,2011-08-22 19:31:41.094-04,7,12,19
8259,34,2011-08-22 19:31:41.094-04,8,7,15
8260,35,2011-08-22 19:31:41.094-04,0,11,11
8261,36,2011-08-22 19:31:41.094-04,3,12,15
8262,37,2011-08-22 19:31:41.094-04,8,7,15
8263,38,2011-08-22 19:31:41.094-04,32,3,35
8264,39,2011-08-22 19:31:41.094-04,9,10,19
8265,40,2011-08-22 19:31:41.094-04,12,1,13
8266,41,2011-08-22 19:31:41.094-04,19,0,19
8267,42,2011-08-22 19:31:41.094-04,1,18,19
8268,43,2011-08-22 19:31:41.094-04,2,13,15
8269,44,2011-08-22 19:31:41.094-04,14,5,19
8270,45,2011-08-22 19:31:41.094-04,3,16,19
8271,46,2011-08-22 19:31:41.094-04,10,9,19
8272,47,2011-08-22 19:31:41.094-04,11,0,11
8273,48,2011-08-22 19:31:41.094-04,0,15,15
8274,49,2011-08-22 19:31:41.094-04,10,5,15
8275,50,2011-08-22 19:31:41.094-04,0,15,15
8276,51,2011-08-22 19:31:41.094-04,6,9,15
8277,52,2011-08-22 19:31:41.094-04,13,1,14
8278,53,2011-08-22 19:31:41.094-04,13,2,15
8279,55,2011-08-22 19:31:41.094-04,7,8,15
8280,56,2011-08-22 19:31:41.094-04,4,11,15
8281,57,2011-08-22 19:31:41.094-04,3,8,11
8282,3,2011-08-22 19:32:42.203-04,9,8,17
8283,5,2011-08-22 19:32:42.203-04,6,9,15
8284,6,2011-08-22 19:32:42.203-04,13,2,15
8285,8,2011-08-22 19:32:42.203-04,2,13,15
8286,9,2011-08-22 19:32:42.203-04,11,8,19
8287,10,2011-08-22 19:32:42.203-04,5,14,19
8288,11,2011-08-22 19:32:42.203-04,0,15,15
8289,12,2011-08-22 19:32:42.203-04,10,5,15
8290,13,2011-08-22 19:32:42.203-04,7,8,15
8291,14,2011-08-22 19:32:42.203-04,0,17,17
8292,15,2011-08-22 19:32:42.203-04,5,10,15
8293,16,2011-08-22 19:32:42.203-04,9,10,19
8294,17,2011-08-22 19:32:42.203-04,5,10,15
8295,18,2011-08-22 19:32:42.203-04,6,9,15
8296,20,2011-08-22 19:32:42.203-04,15,4,19
8297,21,2011-08-22 19:32:42.203-04,5,18,23
8298,22,2011-08-22 19:32:42.203-04,20,27,47
8299,23,2011-08-22 19:32:42.203-04,3,15,18
8300,24,2011-08-22 19:32:42.203-04,1,14,15
8301,25,2011-08-22 19:32:42.203-04,6,9,15
8302,26,2011-08-22 19:32:42.203-04,8,7,15
8303,27,2011-08-22 19:32:42.203-04,5,9,14
8304,30,2011-08-22 19:32:42.203-04,11,4,15
8305,31,2011-08-22 19:32:42.203-04,4,7,11
8306,32,2011-08-22 19:32:42.203-04,10,1,11
8307,33,2011-08-22 19:32:42.203-04,7,12,19
8308,34,2011-08-22 19:32:42.203-04,8,7,15
8309,35,2011-08-22 19:32:42.203-04,0,11,11
8310,36,2011-08-22 19:32:42.203-04,3,12,15
8311,37,2011-08-22 19:32:42.203-04,8,7,15
8312,38,2011-08-22 19:32:42.203-04,32,3,35
8313,39,2011-08-22 19:32:42.203-04,9,10,19
8314,40,2011-08-22 19:32:42.203-04,12,1,13
8315,41,2011-08-22 19:32:42.203-04,19,0,19
8316,42,2011-08-22 19:32:42.203-04,2,17,19
8317,43,2011-08-22 19:32:42.203-04,2,13,15
8318,44,2011-08-22 19:32:42.203-04,15,4,19
8319,45,2011-08-22 19:32:42.203-04,2,17,19
8320,46,2011-08-22 19:32:42.203-04,11,8,19
8321,47,2011-08-22 19:32:42.203-04,11,0,11
8322,48,2011-08-22 19:32:42.203-04,0,15,15
8323,49,2011-08-22 19:32:42.203-04,10,5,15
8324,50,2011-08-22 19:32:42.203-04,0,15,15
8325,51,2011-08-22 19:32:42.203-04,6,9,15
8326,52,2011-08-22 19:32:42.203-04,13,1,14
8327,53,2011-08-22 19:32:42.203-04,13,2,15
8328,55,2011-08-22 19:32:42.203-04,7,8,15
8329,56,2011-08-22 19:32:42.203-04,4,11,15
8330,57,2011-08-22 19:32:42.203-04,3,8,11
8331,3,2011-08-22 19:33:43.169-04,9,8,17
8332,5,2011-08-22 19:33:43.169-04,6,9,15
8333,6,2011-08-22 19:33:43.169-04,13,2,15
8334,8,2011-08-22 19:33:43.169-04,2,13,15
8335,9,2011-08-22 19:33:43.169-04,9,10,19
8336,10,2011-08-22 19:33:43.169-04,5,14,19
8337,11,2011-08-22 19:33:43.169-04,0,15,15
8338,12,2011-08-22 19:33:43.169-04,10,5,15
8339,13,2011-08-22 19:33:43.169-04,7,8,15
8340,14,2011-08-22 19:33:43.169-04,0,17,17
8341,15,2011-08-22 19:33:43.169-04,5,10,15
8342,16,2011-08-22 19:33:43.169-04,9,10,19
8343,17,2011-08-22 19:33:43.169-04,5,10,15
8344,18,2011-08-22 19:33:43.169-04,6,9,15
8345,20,2011-08-22 19:33:43.169-04,15,4,19
8346,21,2011-08-22 19:33:43.169-04,5,18,23
8347,22,2011-08-22 19:33:43.169-04,20,27,47
8348,23,2011-08-22 19:33:43.169-04,3,15,18
8349,24,2011-08-22 19:33:43.169-04,1,14,15
8350,25,2011-08-22 19:33:43.169-04,6,9,15
8351,26,2011-08-22 19:33:43.169-04,8,7,15
8352,27,2011-08-22 19:33:43.169-04,5,9,14
8353,30,2011-08-22 19:33:43.169-04,11,4,15
8354,31,2011-08-22 19:33:43.169-04,4,7,11
8355,32,2011-08-22 19:33:43.169-04,10,1,11
8356,33,2011-08-22 19:33:43.169-04,7,12,19
8357,34,2011-08-22 19:33:43.169-04,8,7,15
8358,35,2011-08-22 19:33:43.169-04,0,11,11
8359,36,2011-08-22 19:33:43.169-04,3,12,15
8360,37,2011-08-22 19:33:43.169-04,8,7,15
8361,38,2011-08-22 19:33:43.169-04,32,3,35
8362,39,2011-08-22 19:33:43.169-04,9,10,19
8363,40,2011-08-22 19:33:43.169-04,12,1,13
8364,41,2011-08-22 19:33:43.169-04,19,0,19
8365,42,2011-08-22 19:33:43.169-04,2,17,19
8366,43,2011-08-22 19:33:43.169-04,3,12,15
8367,44,2011-08-22 19:33:43.169-04,15,4,19
8368,45,2011-08-22 19:33:43.169-04,2,17,19
8369,46,2011-08-22 19:33:43.169-04,11,8,19
8370,47,2011-08-22 19:33:43.169-04,11,0,11
8371,48,2011-08-22 19:33:43.169-04,0,15,15
8372,49,2011-08-22 19:33:43.169-04,10,5,15
8373,50,2011-08-22 19:33:43.169-04,0,15,15
8374,51,2011-08-22 19:33:43.169-04,6,9,15
8375,52,2011-08-22 19:33:43.169-04,11,3,14
8376,53,2011-08-22 19:33:43.169-04,13,2,15
8377,55,2011-08-22 19:33:43.169-04,7,8,15
8378,56,2011-08-22 19:33:43.169-04,4,11,15
8379,57,2011-08-22 19:33:43.169-04,3,8,11
8380,3,2011-08-22 19:34:44.029-04,9,8,17
8381,5,2011-08-22 19:34:44.029-04,6,9,15
8382,6,2011-08-22 19:34:44.029-04,13,2,15
8383,8,2011-08-22 19:34:44.029-04,2,13,15
8384,9,2011-08-22 19:34:44.029-04,9,10,19
8385,10,2011-08-22 19:34:44.029-04,5,14,19
8386,11,2011-08-22 19:34:44.029-04,0,15,15
8387,12,2011-08-22 19:34:44.029-04,10,5,15
8388,13,2011-08-22 19:34:44.029-04,7,8,15
8389,14,2011-08-22 19:34:44.029-04,0,17,17
8390,15,2011-08-22 19:34:44.029-04,5,10,15
8391,16,2011-08-22 19:34:44.029-04,9,10,19
8392,17,2011-08-22 19:34:44.029-04,5,10,15
8393,18,2011-08-22 19:34:44.029-04,6,9,15
8394,20,2011-08-22 19:34:44.029-04,15,4,19
8395,21,2011-08-22 19:34:44.029-04,5,18,23
8396,22,2011-08-22 19:34:44.029-04,20,27,47
8397,23,2011-08-22 19:34:44.029-04,3,15,18
8398,24,2011-08-22 19:34:44.029-04,1,14,15
8399,25,2011-08-22 19:34:44.029-04,5,10,15
8400,26,2011-08-22 19:34:44.029-04,8,7,15
8401,27,2011-08-22 19:34:44.029-04,5,9,14
8402,30,2011-08-22 19:34:44.029-04,11,4,15
8403,31,2011-08-22 19:34:44.029-04,4,7,11
8404,32,2011-08-22 19:34:44.029-04,9,2,11
8405,33,2011-08-22 19:34:44.029-04,7,12,19
8406,34,2011-08-22 19:34:44.029-04,8,7,15
8407,35,2011-08-22 19:34:44.029-04,1,10,11
8408,36,2011-08-22 19:34:44.029-04,3,12,15
8409,37,2011-08-22 19:34:44.029-04,8,7,15
8410,38,2011-08-22 19:34:44.029-04,32,3,35
8411,39,2011-08-22 19:34:44.029-04,9,10,19
8412,40,2011-08-22 19:34:44.029-04,12,1,13
8413,41,2011-08-22 19:34:44.029-04,19,0,19
8414,42,2011-08-22 19:34:44.029-04,2,17,19
8415,43,2011-08-22 19:34:44.029-04,3,12,15
8416,44,2011-08-22 19:34:44.029-04,15,4,19
8417,45,2011-08-22 19:34:44.029-04,2,17,19
8418,46,2011-08-22 19:34:44.029-04,11,8,19
8419,47,2011-08-22 19:34:44.029-04,11,0,11
8420,48,2011-08-22 19:34:44.029-04,0,15,15
8421,49,2011-08-22 19:34:44.029-04,10,5,15
8422,50,2011-08-22 19:34:44.029-04,0,15,15
8423,51,2011-08-22 19:34:44.029-04,6,9,15
8424,52,2011-08-22 19:34:44.029-04,11,3,14
8425,53,2011-08-22 19:34:44.029-04,13,2,15
8426,55,2011-08-22 19:34:44.029-04,7,8,15
8427,56,2011-08-22 19:34:44.029-04,4,11,15
8428,57,2011-08-22 19:34:44.029-04,3,8,11
8429,3,2011-08-22 19:35:44.917-04,9,8,17
8430,5,2011-08-22 19:35:44.917-04,6,9,15
8431,6,2011-08-22 19:35:44.917-04,13,2,15
8432,8,2011-08-22 19:35:44.917-04,2,13,15
8433,9,2011-08-22 19:35:44.917-04,9,10,19
8434,10,2011-08-22 19:35:44.917-04,5,14,19
8435,11,2011-08-22 19:35:44.917-04,0,15,15
8436,12,2011-08-22 19:35:44.917-04,10,5,15
8437,13,2011-08-22 19:35:44.917-04,7,8,15
8438,14,2011-08-22 19:35:44.917-04,0,17,17
8439,15,2011-08-22 19:35:44.917-04,5,10,15
8440,16,2011-08-22 19:35:44.917-04,9,10,19
8441,17,2011-08-22 19:35:44.917-04,5,10,15
8442,18,2011-08-22 19:35:44.917-04,6,9,15
8443,20,2011-08-22 19:35:44.917-04,15,4,19
8444,21,2011-08-22 19:35:44.917-04,5,18,23
8445,22,2011-08-22 19:35:44.917-04,21,26,47
8446,23,2011-08-22 19:35:44.917-04,1,17,18
8447,24,2011-08-22 19:35:44.917-04,1,14,15
8448,25,2011-08-22 19:35:44.917-04,5,10,15
8449,26,2011-08-22 19:35:44.917-04,8,7,15
8450,27,2011-08-22 19:35:44.917-04,5,9,14
8451,30,2011-08-22 19:35:44.917-04,11,4,15
8452,31,2011-08-22 19:35:44.917-04,4,7,11
8453,32,2011-08-22 19:35:44.917-04,10,1,11
8454,33,2011-08-22 19:35:44.917-04,7,12,19
8455,34,2011-08-22 19:35:44.917-04,8,7,15
8456,35,2011-08-22 19:35:44.917-04,1,10,11
8457,36,2011-08-22 19:35:44.917-04,3,12,15
8458,37,2011-08-22 19:35:44.917-04,8,7,15
8459,38,2011-08-22 19:35:44.917-04,32,3,35
8460,39,2011-08-22 19:35:44.917-04,9,10,19
8461,40,2011-08-22 19:35:44.917-04,12,1,13
8462,41,2011-08-22 19:35:44.917-04,19,0,19
8463,42,2011-08-22 19:35:44.917-04,2,17,19
8464,43,2011-08-22 19:35:44.917-04,3,12,15
8465,44,2011-08-22 19:35:44.917-04,15,4,19
8466,45,2011-08-22 19:35:44.917-04,2,17,19
8467,46,2011-08-22 19:35:44.917-04,11,8,19
8468,47,2011-08-22 19:35:44.917-04,11,0,11
8469,48,2011-08-22 19:35:44.917-04,0,15,15
8470,49,2011-08-22 19:35:44.917-04,10,5,15
8471,50,2011-08-22 19:35:44.917-04,0,15,15
8472,51,2011-08-22 19:35:44.917-04,6,9,15
8473,52,2011-08-22 19:35:44.917-04,11,3,14
8474,53,2011-08-22 19:35:44.917-04,13,2,15
8475,55,2011-08-22 19:35:44.917-04,7,8,15
8476,56,2011-08-22 19:35:44.917-04,4,11,15
8477,57,2011-08-22 19:35:44.917-04,3,8,11
8478,3,2011-08-22 19:36:46.025-04,9,8,17
8479,5,2011-08-22 19:36:46.025-04,6,9,15
8480,6,2011-08-22 19:36:46.025-04,13,2,15
8481,8,2011-08-22 19:36:46.025-04,3,12,15
8482,9,2011-08-22 19:36:46.025-04,9,10,19
8483,10,2011-08-22 19:36:46.025-04,5,14,19
8484,11,2011-08-22 19:36:46.025-04,0,15,15
8485,12,2011-08-22 19:36:46.025-04,10,5,15
8486,13,2011-08-22 19:36:46.025-04,7,8,15
8487,14,2011-08-22 19:36:46.025-04,0,17,17
8488,15,2011-08-22 19:36:46.025-04,5,10,15
8489,16,2011-08-22 19:36:46.025-04,9,10,19
8490,17,2011-08-22 19:36:46.025-04,5,10,15
8491,18,2011-08-22 19:36:46.025-04,6,9,15
8492,20,2011-08-22 19:36:46.025-04,15,4,19
8493,21,2011-08-22 19:36:46.025-04,5,18,23
8494,22,2011-08-22 19:36:46.025-04,21,26,47
8495,23,2011-08-22 19:36:46.025-04,2,16,18
8496,24,2011-08-22 19:36:46.025-04,1,14,15
8497,25,2011-08-22 19:36:46.025-04,5,10,15
8498,26,2011-08-22 19:36:46.025-04,8,7,15
8499,27,2011-08-22 19:36:46.025-04,5,9,14
8500,30,2011-08-22 19:36:46.025-04,11,4,15
8501,31,2011-08-22 19:36:46.025-04,4,7,11
8502,32,2011-08-22 19:36:46.025-04,10,1,11
8503,33,2011-08-22 19:36:46.025-04,7,12,19
8504,34,2011-08-22 19:36:46.025-04,8,7,15
8505,35,2011-08-22 19:36:46.025-04,1,10,11
8506,36,2011-08-22 19:36:46.025-04,1,14,15
8507,37,2011-08-22 19:36:46.025-04,8,7,15
8508,38,2011-08-22 19:36:46.025-04,32,3,35
8509,39,2011-08-22 19:36:46.025-04,9,10,19
8510,40,2011-08-22 19:36:46.025-04,12,1,13
8511,41,2011-08-22 19:36:46.025-04,19,0,19
8512,42,2011-08-22 19:36:46.025-04,2,17,19
8513,43,2011-08-22 19:36:46.025-04,3,12,15
8514,44,2011-08-22 19:36:46.025-04,15,4,19
8515,45,2011-08-22 19:36:46.025-04,2,17,19
8516,46,2011-08-22 19:36:46.025-04,11,8,19
8517,47,2011-08-22 19:36:46.025-04,11,0,11
8518,48,2011-08-22 19:36:46.025-04,0,15,15
8519,49,2011-08-22 19:36:46.025-04,10,5,15
8520,50,2011-08-22 19:36:46.025-04,0,15,15
8521,51,2011-08-22 19:36:46.025-04,6,9,15
8522,52,2011-08-22 19:36:46.025-04,9,5,14
8523,53,2011-08-22 19:36:46.025-04,13,2,15
8524,55,2011-08-22 19:36:46.025-04,7,8,15
8525,56,2011-08-22 19:36:46.025-04,4,11,15
8526,57,2011-08-22 19:36:46.025-04,3,8,11
8527,3,2011-08-22 19:37:47.017-04,9,8,17
8528,5,2011-08-22 19:37:47.017-04,6,9,15
8529,6,2011-08-22 19:37:47.017-04,13,2,15
8530,8,2011-08-22 19:37:47.017-04,4,11,15
8531,9,2011-08-22 19:37:47.017-04,9,10,19
8532,10,2011-08-22 19:37:47.017-04,5,14,19
8533,11,2011-08-22 19:37:47.017-04,0,15,15
8534,12,2011-08-22 19:37:47.017-04,10,5,15
8535,13,2011-08-22 19:37:47.017-04,7,8,15
8536,14,2011-08-22 19:37:47.017-04,0,17,17
8537,15,2011-08-22 19:37:47.017-04,6,9,15
8538,16,2011-08-22 19:37:47.017-04,9,10,19
8539,17,2011-08-22 19:37:47.017-04,5,10,15
8540,18,2011-08-22 19:37:47.017-04,6,9,15
8541,20,2011-08-22 19:37:47.017-04,15,4,19
8542,21,2011-08-22 19:37:47.017-04,5,18,23
8543,22,2011-08-22 19:37:47.017-04,21,26,47
8544,23,2011-08-22 19:37:47.017-04,2,16,18
8545,24,2011-08-22 19:37:47.017-04,1,14,15
8546,25,2011-08-22 19:37:47.017-04,5,10,15
8547,26,2011-08-22 19:37:47.017-04,8,7,15
8548,27,2011-08-22 19:37:47.017-04,5,9,14
8549,30,2011-08-22 19:37:47.017-04,11,4,15
8550,31,2011-08-22 19:37:47.017-04,4,7,11
8551,32,2011-08-22 19:37:47.017-04,9,2,11
8552,33,2011-08-22 19:37:47.017-04,7,12,19
8553,34,2011-08-22 19:37:47.017-04,8,7,15
8554,35,2011-08-22 19:37:47.017-04,1,10,11
8555,36,2011-08-22 19:37:47.017-04,1,14,15
8556,37,2011-08-22 19:37:47.017-04,8,7,15
8557,38,2011-08-22 19:37:47.017-04,32,3,35
8558,39,2011-08-22 19:37:47.017-04,9,10,19
8559,40,2011-08-22 19:37:47.017-04,12,1,13
8560,41,2011-08-22 19:37:47.017-04,19,0,19
8561,42,2011-08-22 19:37:47.017-04,2,17,19
8562,43,2011-08-22 19:37:47.017-04,3,12,15
8563,44,2011-08-22 19:37:47.017-04,15,4,19
8564,45,2011-08-22 19:37:47.017-04,2,17,19
8565,46,2011-08-22 19:37:47.017-04,11,8,19
8566,47,2011-08-22 19:37:47.017-04,11,0,11
8567,48,2011-08-22 19:37:47.017-04,0,15,15
8568,49,2011-08-22 19:37:47.017-04,10,5,15
8569,50,2011-08-22 19:37:47.017-04,1,14,15
8570,51,2011-08-22 19:37:47.017-04,6,9,15
8571,52,2011-08-22 19:37:47.017-04,9,5,14
8572,53,2011-08-22 19:37:47.017-04,13,2,15
8573,55,2011-08-22 19:37:47.017-04,7,8,15
8574,56,2011-08-22 19:37:47.017-04,4,11,15
8575,57,2011-08-22 19:37:47.017-04,3,8,11
8576,3,2011-08-22 19:38:47.825-04,9,8,17
8577,5,2011-08-22 19:38:47.825-04,6,9,15
8578,6,2011-08-22 19:38:47.825-04,13,2,15
8579,8,2011-08-22 19:38:47.825-04,5,10,15
8580,9,2011-08-22 19:38:47.825-04,9,10,19
8581,10,2011-08-22 19:38:47.825-04,5,14,19
8582,11,2011-08-22 19:38:47.825-04,0,15,15
8583,12,2011-08-22 19:38:47.825-04,10,5,15
8584,13,2011-08-22 19:38:47.825-04,7,8,15
8585,14,2011-08-22 19:38:47.825-04,0,17,17
8586,15,2011-08-22 19:38:47.825-04,6,9,15
8587,16,2011-08-22 19:38:47.825-04,9,10,19
8588,17,2011-08-22 19:38:47.825-04,5,10,15
8589,18,2011-08-22 19:38:47.825-04,6,9,15
8590,20,2011-08-22 19:38:47.825-04,15,4,19
8591,21,2011-08-22 19:38:47.825-04,5,18,23
8592,22,2011-08-22 19:38:47.825-04,20,27,47
8593,23,2011-08-22 19:38:47.825-04,2,16,18
8594,24,2011-08-22 19:38:47.825-04,4,11,15
8595,25,2011-08-22 19:38:47.825-04,5,10,15
8596,26,2011-08-22 19:38:47.825-04,8,7,15
8597,27,2011-08-22 19:38:47.825-04,5,9,14
8598,30,2011-08-22 19:38:47.825-04,11,4,15
8599,31,2011-08-22 19:38:47.825-04,4,7,11
8600,32,2011-08-22 19:38:47.825-04,9,2,11
8601,33,2011-08-22 19:38:47.825-04,7,12,19
8602,34,2011-08-22 19:38:47.825-04,8,7,15
8603,35,2011-08-22 19:38:47.825-04,1,10,11
8604,36,2011-08-22 19:38:47.825-04,1,14,15
8605,37,2011-08-22 19:38:47.825-04,8,7,15
8606,38,2011-08-22 19:38:47.825-04,32,3,35
8607,39,2011-08-22 19:38:47.825-04,9,10,19
8608,40,2011-08-22 19:38:47.825-04,12,1,13
8609,41,2011-08-22 19:38:47.825-04,19,0,19
8610,42,2011-08-22 19:38:47.825-04,2,17,19
8611,43,2011-08-22 19:38:47.825-04,3,12,15
8612,44,2011-08-22 19:38:47.825-04,15,4,19
8613,45,2011-08-22 19:38:47.825-04,2,17,19
8614,46,2011-08-22 19:38:47.825-04,11,8,19
8615,47,2011-08-22 19:38:47.825-04,11,0,11
8616,48,2011-08-22 19:38:47.825-04,0,15,15
8617,49,2011-08-22 19:38:47.825-04,10,5,15
8618,50,2011-08-22 19:38:47.825-04,1,14,15
8619,51,2011-08-22 19:38:47.825-04,6,9,15
8620,52,2011-08-22 19:38:47.825-04,9,5,14
8621,53,2011-08-22 19:38:47.825-04,13,2,15
8622,55,2011-08-22 19:38:47.825-04,9,6,15
8623,56,2011-08-22 19:38:47.825-04,4,11,15
8624,57,2011-08-22 19:38:47.825-04,3,8,11
8625,3,2011-08-22 19:39:48.711-04,9,8,17
8626,5,2011-08-22 19:39:48.711-04,6,9,15
8627,6,2011-08-22 19:39:48.711-04,13,2,15
8628,8,2011-08-22 19:39:48.711-04,5,10,15
8629,9,2011-08-22 19:39:48.711-04,9,10,19
8630,10,2011-08-22 19:39:48.711-04,5,14,19
8631,11,2011-08-22 19:39:48.711-04,0,15,15
8632,12,2011-08-22 19:39:48.711-04,10,5,15
8633,13,2011-08-22 19:39:48.711-04,7,8,15
8634,14,2011-08-22 19:39:48.711-04,0,17,17
8635,15,2011-08-22 19:39:48.711-04,6,9,15
8636,16,2011-08-22 19:39:48.711-04,9,10,19
8637,17,2011-08-22 19:39:48.711-04,4,11,15
8638,18,2011-08-22 19:39:48.711-04,6,9,15
8639,20,2011-08-22 19:39:48.711-04,15,4,19
8640,21,2011-08-22 19:39:48.711-04,5,18,23
8641,22,2011-08-22 19:39:48.711-04,19,28,47
8642,23,2011-08-22 19:39:48.711-04,1,17,18
8643,24,2011-08-22 19:39:48.711-04,4,11,15
8644,25,2011-08-22 19:39:48.711-04,5,10,15
8645,26,2011-08-22 19:39:48.711-04,8,7,15
8646,27,2011-08-22 19:39:48.711-04,5,9,14
8647,30,2011-08-22 19:39:48.711-04,11,4,15
8648,31,2011-08-22 19:39:48.711-04,4,7,11
8649,32,2011-08-22 19:39:48.711-04,9,2,11
8650,33,2011-08-22 19:39:48.711-04,7,12,19
8651,34,2011-08-22 19:39:48.711-04,8,7,15
8652,35,2011-08-22 19:39:48.711-04,1,10,11
8653,36,2011-08-22 19:39:48.711-04,1,14,15
8654,37,2011-08-22 19:39:48.711-04,8,7,15
8655,38,2011-08-22 19:39:48.711-04,32,3,35
8656,39,2011-08-22 19:39:48.711-04,9,10,19
8657,40,2011-08-22 19:39:48.711-04,12,1,13
8658,41,2011-08-22 19:39:48.711-04,19,0,19
8659,42,2011-08-22 19:39:48.711-04,2,17,19
8660,43,2011-08-22 19:39:48.711-04,3,12,15
8661,44,2011-08-22 19:39:48.711-04,15,4,19
8662,45,2011-08-22 19:39:48.711-04,2,17,19
8663,46,2011-08-22 19:39:48.711-04,11,8,19
8664,47,2011-08-22 19:39:48.711-04,11,0,11
8665,48,2011-08-22 19:39:48.711-04,0,15,15
8666,49,2011-08-22 19:39:48.711-04,9,6,15
8667,50,2011-08-22 19:39:48.711-04,1,14,15
8668,51,2011-08-22 19:39:48.711-04,6,9,15
8669,52,2011-08-22 19:39:48.711-04,9,5,14
8670,53,2011-08-22 19:39:48.711-04,13,2,15
8671,55,2011-08-22 19:39:48.711-04,9,6,15
8672,56,2011-08-22 19:39:48.711-04,4,11,15
8673,57,2011-08-22 19:39:48.711-04,3,8,11
8674,3,2011-08-22 19:40:49.561-04,9,8,17
8675,5,2011-08-22 19:40:49.561-04,7,8,15
8676,6,2011-08-22 19:40:49.561-04,13,2,15
8677,8,2011-08-22 19:40:49.561-04,5,10,15
8678,9,2011-08-22 19:40:49.561-04,9,10,19
8679,10,2011-08-22 19:40:49.561-04,5,14,19
8680,11,2011-08-22 19:40:49.561-04,1,14,15
8681,12,2011-08-22 19:40:49.561-04,11,4,15
8682,13,2011-08-22 19:40:49.561-04,7,8,15
8683,14,2011-08-22 19:40:49.561-04,0,17,17
8684,15,2011-08-22 19:40:49.561-04,6,9,15
8685,16,2011-08-22 19:40:49.561-04,9,10,19
8686,17,2011-08-22 19:40:49.561-04,4,11,15
8687,18,2011-08-22 19:40:49.561-04,6,9,15
8688,20,2011-08-22 19:40:49.561-04,15,4,19
8689,21,2011-08-22 19:40:49.561-04,5,18,23
8690,22,2011-08-22 19:40:49.561-04,19,28,47
8691,23,2011-08-22 19:40:49.561-04,1,17,18
8692,24,2011-08-22 19:40:49.561-04,4,11,15
8693,25,2011-08-22 19:40:49.561-04,5,10,15
8694,26,2011-08-22 19:40:49.561-04,8,7,15
8695,27,2011-08-22 19:40:49.561-04,5,9,14
8696,30,2011-08-22 19:40:49.561-04,11,4,15
8697,31,2011-08-22 19:40:49.561-04,4,7,11
8698,32,2011-08-22 19:40:49.561-04,9,2,11
8699,33,2011-08-22 19:40:49.561-04,7,12,19
8700,34,2011-08-22 19:40:49.561-04,8,7,15
8701,35,2011-08-22 19:40:49.561-04,1,10,11
8702,36,2011-08-22 19:40:49.561-04,1,14,15
8703,37,2011-08-22 19:40:49.561-04,8,7,15
8704,38,2011-08-22 19:40:49.561-04,32,3,35
8705,39,2011-08-22 19:40:49.561-04,10,9,19
8706,40,2011-08-22 19:40:49.561-04,12,1,13
8707,41,2011-08-22 19:40:49.561-04,19,0,19
8708,42,2011-08-22 19:40:49.561-04,2,17,19
8709,43,2011-08-22 19:40:49.561-04,3,12,15
8710,44,2011-08-22 19:40:49.561-04,15,4,19
8711,45,2011-08-22 19:40:49.561-04,3,16,19
8712,46,2011-08-22 19:40:49.561-04,11,8,19
8713,47,2011-08-22 19:40:49.561-04,11,0,11
8714,48,2011-08-22 19:40:49.561-04,0,15,15
8715,49,2011-08-22 19:40:49.561-04,9,6,15
8716,50,2011-08-22 19:40:49.561-04,1,14,15
8717,51,2011-08-22 19:40:49.561-04,6,9,15
8718,52,2011-08-22 19:40:49.561-04,9,5,14
8719,53,2011-08-22 19:40:49.561-04,13,2,15
8720,55,2011-08-22 19:40:49.561-04,9,6,15
8721,56,2011-08-22 19:40:49.561-04,4,11,15
8722,57,2011-08-22 19:40:49.561-04,3,8,11
8723,3,2011-08-22 19:41:50.517-04,9,8,17
8724,5,2011-08-22 19:41:50.517-04,7,8,15
8725,6,2011-08-22 19:41:50.517-04,13,2,15
8726,8,2011-08-22 19:41:50.517-04,5,10,15
8727,9,2011-08-22 19:41:50.517-04,9,10,19
8728,10,2011-08-22 19:41:50.517-04,5,14,19
8729,11,2011-08-22 19:41:50.517-04,1,14,15
8730,12,2011-08-22 19:41:50.517-04,11,4,15
8731,13,2011-08-22 19:41:50.517-04,7,8,15
8732,14,2011-08-22 19:41:50.517-04,4,13,17
8733,15,2011-08-22 19:41:50.517-04,6,9,15
8734,16,2011-08-22 19:41:50.517-04,9,10,19
8735,17,2011-08-22 19:41:50.517-04,4,11,15
8736,18,2011-08-22 19:41:50.517-04,6,9,15
8737,20,2011-08-22 19:41:50.517-04,15,4,19
8738,21,2011-08-22 19:41:50.517-04,5,18,23
8739,22,2011-08-22 19:41:50.517-04,19,28,47
8740,23,2011-08-22 19:41:50.517-04,1,17,18
8741,24,2011-08-22 19:41:50.517-04,3,12,15
8742,25,2011-08-22 19:41:50.517-04,5,10,15
8743,26,2011-08-22 19:41:50.517-04,8,7,15
8744,27,2011-08-22 19:41:50.517-04,5,9,14
8745,30,2011-08-22 19:41:50.517-04,11,4,15
8746,31,2011-08-22 19:41:50.517-04,4,7,11
8747,32,2011-08-22 19:41:50.517-04,9,2,11
8748,33,2011-08-22 19:41:50.517-04,7,12,19
8749,34,2011-08-22 19:41:50.517-04,8,7,15
8750,35,2011-08-22 19:41:50.517-04,1,10,11
8751,36,2011-08-22 19:41:50.517-04,1,14,15
8752,37,2011-08-22 19:41:50.517-04,8,7,15
8753,38,2011-08-22 19:41:50.517-04,32,3,35
8754,39,2011-08-22 19:41:50.517-04,10,9,19
8755,40,2011-08-22 19:41:50.517-04,12,1,13
8756,41,2011-08-22 19:41:50.517-04,19,0,19
8757,42,2011-08-22 19:41:50.517-04,3,16,19
8758,43,2011-08-22 19:41:50.517-04,3,12,15
8759,44,2011-08-22 19:41:50.517-04,15,4,19
8760,45,2011-08-22 19:41:50.517-04,3,16,19
8761,46,2011-08-22 19:41:50.517-04,11,8,19
8762,47,2011-08-22 19:41:50.517-04,11,0,11
8763,48,2011-08-22 19:41:50.517-04,0,15,15
8764,49,2011-08-22 19:41:50.517-04,9,6,15
8765,50,2011-08-22 19:41:50.517-04,1,14,15
8766,51,2011-08-22 19:41:50.517-04,6,9,15
8767,52,2011-08-22 19:41:50.517-04,9,5,14
8768,53,2011-08-22 19:41:50.517-04,13,2,15
8769,55,2011-08-22 19:41:50.517-04,8,7,15
8770,56,2011-08-22 19:41:50.517-04,4,11,15
8771,57,2011-08-22 19:41:50.517-04,4,7,11
8772,3,2011-08-22 19:42:51.681-04,9,8,17
8773,5,2011-08-22 19:42:51.681-04,7,8,15
8774,6,2011-08-22 19:42:51.681-04,13,2,15
8775,8,2011-08-22 19:42:51.681-04,5,10,15
8776,9,2011-08-22 19:42:51.681-04,9,10,19
8777,10,2011-08-22 19:42:51.681-04,5,14,19
8778,11,2011-08-22 19:42:51.681-04,0,15,15
8779,12,2011-08-22 19:42:51.681-04,11,4,15
8780,13,2011-08-22 19:42:51.681-04,7,8,15
8781,14,2011-08-22 19:42:51.681-04,4,13,17
8782,15,2011-08-22 19:42:51.681-04,6,9,15
8783,16,2011-08-22 19:42:51.681-04,9,10,19
8784,17,2011-08-22 19:42:51.681-04,4,11,15
8785,18,2011-08-22 19:42:51.681-04,6,9,15
8786,20,2011-08-22 19:42:51.681-04,15,4,19
8787,21,2011-08-22 19:42:51.681-04,5,18,23
8788,22,2011-08-22 19:42:51.681-04,19,28,47
8789,23,2011-08-22 19:42:51.681-04,1,17,18
8790,24,2011-08-22 19:42:51.681-04,3,12,15
8791,25,2011-08-22 19:42:51.681-04,5,10,15
8792,26,2011-08-22 19:42:51.681-04,8,7,15
8793,27,2011-08-22 19:42:51.681-04,5,9,14
8794,30,2011-08-22 19:42:51.681-04,11,4,15
8795,31,2011-08-22 19:42:51.681-04,4,7,11
8796,32,2011-08-22 19:42:51.681-04,9,2,11
8797,33,2011-08-22 19:42:51.681-04,7,12,19
8798,34,2011-08-22 19:42:51.681-04,8,7,15
8799,35,2011-08-22 19:42:51.681-04,1,10,11
8800,36,2011-08-22 19:42:51.681-04,1,14,15
8801,37,2011-08-22 19:42:51.681-04,8,7,15
8802,38,2011-08-22 19:42:51.681-04,32,3,35
8803,39,2011-08-22 19:42:51.681-04,11,8,19
8804,40,2011-08-22 19:42:51.681-04,12,1,13
8805,41,2011-08-22 19:42:51.681-04,19,0,19
8806,42,2011-08-22 19:42:51.681-04,3,16,19
8807,43,2011-08-22 19:42:51.681-04,3,12,15
8808,44,2011-08-22 19:42:51.681-04,15,4,19
8809,45,2011-08-22 19:42:51.681-04,3,16,19
8810,46,2011-08-22 19:42:51.681-04,11,8,19
8811,47,2011-08-22 19:42:51.681-04,11,0,11
8812,48,2011-08-22 19:42:51.681-04,0,15,15
8813,49,2011-08-22 19:42:51.681-04,9,6,15
8814,50,2011-08-22 19:42:51.681-04,1,14,15
8815,51,2011-08-22 19:42:51.681-04,6,9,15
8816,52,2011-08-22 19:42:51.681-04,9,5,14
8817,53,2011-08-22 19:42:51.681-04,14,1,15
8818,55,2011-08-22 19:42:51.681-04,7,8,15
8819,56,2011-08-22 19:42:51.681-04,4,11,15
8820,57,2011-08-22 19:42:51.681-04,4,7,11
8821,3,2011-08-22 19:43:52.52-04,9,8,17
8822,5,2011-08-22 19:43:52.52-04,7,8,15
8823,6,2011-08-22 19:43:52.52-04,13,2,15
8824,8,2011-08-22 19:43:52.52-04,5,10,15
8825,9,2011-08-22 19:43:52.52-04,9,10,19
8826,10,2011-08-22 19:43:52.52-04,5,14,19
8827,11,2011-08-22 19:43:52.52-04,0,15,15
8828,12,2011-08-22 19:43:52.52-04,11,4,15
8829,13,2011-08-22 19:43:52.52-04,7,8,15
8830,14,2011-08-22 19:43:52.52-04,4,13,17
8831,15,2011-08-22 19:43:52.52-04,6,9,15
8832,16,2011-08-22 19:43:52.52-04,9,10,19
8833,17,2011-08-22 19:43:52.52-04,4,11,15
8834,18,2011-08-22 19:43:52.52-04,9,6,15
8835,20,2011-08-22 19:43:52.52-04,15,4,19
8836,21,2011-08-22 19:43:52.52-04,5,18,23
8837,22,2011-08-22 19:43:52.52-04,19,28,47
8838,23,2011-08-22 19:43:52.52-04,1,17,18
8839,24,2011-08-22 19:43:52.52-04,3,12,15
8840,25,2011-08-22 19:43:52.52-04,5,10,15
8841,26,2011-08-22 19:43:52.52-04,8,7,15
8842,27,2011-08-22 19:43:52.52-04,5,9,14
8843,30,2011-08-22 19:43:52.52-04,11,4,15
8844,31,2011-08-22 19:43:52.52-04,4,7,11
8845,32,2011-08-22 19:43:52.52-04,9,2,11
8846,33,2011-08-22 19:43:52.52-04,7,12,19
8847,34,2011-08-22 19:43:52.52-04,8,7,15
8848,35,2011-08-22 19:43:52.52-04,1,10,11
8849,36,2011-08-22 19:43:52.52-04,1,14,15
8850,37,2011-08-22 19:43:52.52-04,8,7,15
8851,38,2011-08-22 19:43:52.52-04,32,3,35
8852,39,2011-08-22 19:43:52.52-04,12,7,19
8853,40,2011-08-22 19:43:52.52-04,12,1,13
8854,41,2011-08-22 19:43:52.52-04,19,0,19
8855,42,2011-08-22 19:43:52.52-04,3,16,19
8856,43,2011-08-22 19:43:52.52-04,3,12,15
8857,44,2011-08-22 19:43:52.52-04,15,4,19
8858,45,2011-08-22 19:43:52.52-04,5,14,19
8859,46,2011-08-22 19:43:52.52-04,11,8,19
8860,47,2011-08-22 19:43:52.52-04,11,0,11
8861,48,2011-08-22 19:43:52.52-04,0,15,15
8862,49,2011-08-22 19:43:52.52-04,9,6,15
8863,50,2011-08-22 19:43:52.52-04,1,14,15
8864,51,2011-08-22 19:43:52.52-04,6,9,15
8865,52,2011-08-22 19:43:52.52-04,9,5,14
8866,53,2011-08-22 19:43:52.52-04,14,1,15
8867,55,2011-08-22 19:43:52.52-04,7,8,15
8868,56,2011-08-22 19:43:52.52-04,4,11,15
8869,57,2011-08-22 19:43:52.52-04,4,7,11
8870,3,2011-08-22 19:44:53.445-04,9,8,17
8871,5,2011-08-22 19:44:53.445-04,7,8,15
8872,6,2011-08-22 19:44:53.445-04,13,2,15
8873,8,2011-08-22 19:44:53.445-04,5,10,15
8874,9,2011-08-22 19:44:53.445-04,9,10,19
8875,10,2011-08-22 19:44:53.445-04,5,14,19
8876,11,2011-08-22 19:44:53.445-04,0,15,15
8877,12,2011-08-22 19:44:53.445-04,11,4,15
8878,13,2011-08-22 19:44:53.445-04,7,8,15
8879,14,2011-08-22 19:44:53.445-04,4,13,17
8880,15,2011-08-22 19:44:53.445-04,4,11,15
8881,16,2011-08-22 19:44:53.445-04,8,11,19
8882,17,2011-08-22 19:44:53.445-04,4,11,15
8883,18,2011-08-22 19:44:53.445-04,9,6,15
8884,20,2011-08-22 19:44:53.445-04,15,4,19
8885,21,2011-08-22 19:44:53.445-04,5,18,23
8886,22,2011-08-22 19:44:53.445-04,19,28,47
8887,23,2011-08-22 19:44:53.445-04,1,17,18
8888,24,2011-08-22 19:44:53.445-04,3,12,15
8889,25,2011-08-22 19:44:53.445-04,5,10,15
8890,26,2011-08-22 19:44:53.445-04,8,7,15
8891,27,2011-08-22 19:44:53.445-04,5,9,14
8892,30,2011-08-22 19:44:53.445-04,11,4,15
8893,31,2011-08-22 19:44:53.445-04,4,7,11
8894,32,2011-08-22 19:44:53.445-04,9,2,11
8895,33,2011-08-22 19:44:53.445-04,7,12,19
8896,34,2011-08-22 19:44:53.445-04,8,7,15
8897,35,2011-08-22 19:44:53.445-04,1,10,11
8898,36,2011-08-22 19:44:53.445-04,1,14,15
8899,37,2011-08-22 19:44:53.445-04,8,7,15
8900,38,2011-08-22 19:44:53.445-04,32,3,35
8901,39,2011-08-22 19:44:53.445-04,12,7,19
8902,40,2011-08-22 19:44:53.445-04,12,1,13
8903,41,2011-08-22 19:44:53.445-04,19,0,19
8904,42,2011-08-22 19:44:53.445-04,3,16,19
8905,43,2011-08-22 19:44:53.445-04,3,12,15
8906,44,2011-08-22 19:44:53.445-04,15,4,19
8907,45,2011-08-22 19:44:53.445-04,6,13,19
8908,46,2011-08-22 19:44:53.445-04,11,8,19
8909,47,2011-08-22 19:44:53.445-04,11,0,11
8910,48,2011-08-22 19:44:53.445-04,0,15,15
8911,49,2011-08-22 19:44:53.445-04,9,6,15
8912,50,2011-08-22 19:44:53.445-04,0,15,15
8913,51,2011-08-22 19:44:53.445-04,6,9,15
8914,52,2011-08-22 19:44:53.445-04,9,5,14
8915,53,2011-08-22 19:44:53.445-04,14,1,15
8916,55,2011-08-22 19:44:53.445-04,7,8,15
8917,56,2011-08-22 19:44:53.445-04,4,11,15
8918,57,2011-08-22 19:44:53.445-04,4,7,11
8919,3,2011-08-22 19:45:54.39-04,9,8,17
8920,5,2011-08-22 19:45:54.39-04,7,8,15
8921,6,2011-08-22 19:45:54.39-04,13,2,15
8922,8,2011-08-22 19:45:54.39-04,5,10,15
8923,9,2011-08-22 19:45:54.39-04,9,10,19
8924,10,2011-08-22 19:45:54.39-04,5,14,19
8925,11,2011-08-22 19:45:54.39-04,0,15,15
8926,12,2011-08-22 19:45:54.39-04,11,4,15
8927,13,2011-08-22 19:45:54.39-04,7,8,15
8928,14,2011-08-22 19:45:54.39-04,4,13,17
8929,15,2011-08-22 19:45:54.39-04,4,11,15
8930,16,2011-08-22 19:45:54.39-04,8,11,19
8931,17,2011-08-22 19:45:54.39-04,4,11,15
8932,18,2011-08-22 19:45:54.39-04,9,6,15
8933,20,2011-08-22 19:45:54.39-04,15,4,19
8934,21,2011-08-22 19:45:54.39-04,5,18,23
8935,22,2011-08-22 19:45:54.39-04,19,28,47
8936,23,2011-08-22 19:45:54.39-04,1,17,18
8937,24,2011-08-22 19:45:54.39-04,2,13,15
8938,25,2011-08-22 19:45:54.39-04,6,9,15
8939,26,2011-08-22 19:45:54.39-04,8,7,15
8940,27,2011-08-22 19:45:54.39-04,5,9,14
8941,30,2011-08-22 19:45:54.39-04,11,4,15
8942,31,2011-08-22 19:45:54.39-04,4,7,11
8943,32,2011-08-22 19:45:54.39-04,9,2,11
8944,33,2011-08-22 19:45:54.39-04,7,12,19
8945,34,2011-08-22 19:45:54.39-04,8,7,15
8946,35,2011-08-22 19:45:54.39-04,1,10,11
8947,36,2011-08-22 19:45:54.39-04,1,14,15
8948,37,2011-08-22 19:45:54.39-04,8,7,15
8949,38,2011-08-22 19:45:54.39-04,32,3,35
8950,39,2011-08-22 19:45:54.39-04,12,7,19
8951,40,2011-08-22 19:45:54.39-04,12,1,13
8952,41,2011-08-22 19:45:54.39-04,19,0,19
8953,42,2011-08-22 19:45:54.39-04,3,16,19
8954,43,2011-08-22 19:45:54.39-04,3,12,15
8955,44,2011-08-22 19:45:54.39-04,15,4,19
8956,45,2011-08-22 19:45:54.39-04,8,11,19
8957,46,2011-08-22 19:45:54.39-04,11,8,19
8958,47,2011-08-22 19:45:54.39-04,11,0,11
8959,48,2011-08-22 19:45:54.39-04,0,15,15
8960,49,2011-08-22 19:45:54.39-04,9,6,15
8961,50,2011-08-22 19:45:54.39-04,0,15,15
8962,51,2011-08-22 19:45:54.39-04,6,9,15
8963,52,2011-08-22 19:45:54.39-04,9,5,14
8964,53,2011-08-22 19:45:54.39-04,14,1,15
8965,55,2011-08-22 19:45:54.39-04,7,8,15
8966,56,2011-08-22 19:45:54.39-04,4,11,15
8967,57,2011-08-22 19:45:54.39-04,4,7,11
8968,3,2011-08-22 19:46:55.438-04,9,8,17
8969,5,2011-08-22 19:46:55.438-04,7,8,15
8970,6,2011-08-22 19:46:55.438-04,13,2,15
8971,8,2011-08-22 19:46:55.438-04,5,10,15
8972,9,2011-08-22 19:46:55.438-04,9,10,19
8973,10,2011-08-22 19:46:55.438-04,5,14,19
8974,11,2011-08-22 19:46:55.438-04,0,15,15
8975,12,2011-08-22 19:46:55.438-04,11,4,15
8976,13,2011-08-22 19:46:55.438-04,7,8,15
8977,14,2011-08-22 19:46:55.438-04,4,13,17
8978,15,2011-08-22 19:46:55.438-04,4,11,15
8979,16,2011-08-22 19:46:55.438-04,8,11,19
8980,17,2011-08-22 19:46:55.438-04,4,11,15
8981,18,2011-08-22 19:46:55.438-04,9,6,15
8982,20,2011-08-22 19:46:55.438-04,15,4,19
8983,21,2011-08-22 19:46:55.438-04,5,18,23
8984,22,2011-08-22 19:46:55.438-04,19,28,47
8985,23,2011-08-22 19:46:55.438-04,1,17,18
8986,24,2011-08-22 19:46:55.438-04,2,13,15
8987,25,2011-08-22 19:46:55.438-04,6,9,15
8988,26,2011-08-22 19:46:55.438-04,8,7,15
8989,27,2011-08-22 19:46:55.438-04,5,9,14
8990,30,2011-08-22 19:46:55.438-04,11,4,15
8991,31,2011-08-22 19:46:55.438-04,4,7,11
8992,32,2011-08-22 19:46:55.438-04,9,2,11
8993,33,2011-08-22 19:46:55.438-04,7,12,19
8994,34,2011-08-22 19:46:55.438-04,8,7,15
8995,35,2011-08-22 19:46:55.438-04,1,10,11
8996,36,2011-08-22 19:46:55.438-04,0,15,15
8997,37,2011-08-22 19:46:55.438-04,8,7,15
8998,38,2011-08-22 19:46:55.438-04,32,3,35
8999,39,2011-08-22 19:46:55.438-04,12,7,19
9000,40,2011-08-22 19:46:55.438-04,12,1,13
9001,41,2011-08-22 19:46:55.438-04,19,0,19
9002,42,2011-08-22 19:46:55.438-04,2,17,19
9003,43,2011-08-22 19:46:55.438-04,3,12,15
9004,44,2011-08-22 19:46:55.438-04,15,4,19
9005,45,2011-08-22 19:46:55.438-04,8,11,19
9006,46,2011-08-22 19:46:55.438-04,11,8,19
9007,47,2011-08-22 19:46:55.438-04,11,0,11
9008,48,2011-08-22 19:46:55.438-04,0,15,15
9009,49,2011-08-22 19:46:55.438-04,9,6,15
9010,50,2011-08-22 19:46:55.438-04,0,15,15
9011,51,2011-08-22 19:46:55.438-04,6,9,15
9012,52,2011-08-22 19:46:55.438-04,9,5,14
9013,53,2011-08-22 19:46:55.438-04,14,1,15
9014,55,2011-08-22 19:46:55.438-04,7,8,15
9015,56,2011-08-22 19:46:55.438-04,4,11,15
9016,57,2011-08-22 19:46:55.438-04,4,7,11
9017,3,2011-08-22 19:47:56.482-04,9,8,17
9018,5,2011-08-22 19:47:56.482-04,7,8,15
9019,6,2011-08-22 19:47:56.482-04,13,2,15
9020,8,2011-08-22 19:47:56.482-04,5,10,15
9021,9,2011-08-22 19:47:56.482-04,9,10,19
9022,10,2011-08-22 19:47:56.482-04,4,15,19
9023,11,2011-08-22 19:47:56.482-04,0,15,15
9024,12,2011-08-22 19:47:56.482-04,11,4,15
9025,13,2011-08-22 19:47:56.482-04,7,8,15
9026,14,2011-08-22 19:47:56.482-04,4,13,17
9027,15,2011-08-22 19:47:56.482-04,4,11,15
9028,16,2011-08-22 19:47:56.482-04,8,11,19
9029,17,2011-08-22 19:47:56.482-04,4,11,15
9030,18,2011-08-22 19:47:56.482-04,9,6,15
9031,20,2011-08-22 19:47:56.482-04,15,4,19
9032,21,2011-08-22 19:47:56.482-04,5,18,23
9033,22,2011-08-22 19:47:56.482-04,19,28,47
9034,23,2011-08-22 19:47:56.482-04,1,17,18
9035,24,2011-08-22 19:47:56.482-04,2,13,15
9036,25,2011-08-22 19:47:56.482-04,6,9,15
9037,26,2011-08-22 19:47:56.482-04,8,7,15
9038,27,2011-08-22 19:47:56.482-04,5,9,14
9039,30,2011-08-22 19:47:56.482-04,11,4,15
9040,31,2011-08-22 19:47:56.482-04,4,7,11
9041,32,2011-08-22 19:47:56.482-04,9,2,11
9042,33,2011-08-22 19:47:56.482-04,7,12,19
9043,34,2011-08-22 19:47:56.482-04,8,7,15
9044,35,2011-08-22 19:47:56.482-04,1,10,11
9045,36,2011-08-22 19:47:56.482-04,0,15,15
9046,37,2011-08-22 19:47:56.482-04,8,7,15
9047,38,2011-08-22 19:47:56.482-04,32,3,35
9048,39,2011-08-22 19:47:56.482-04,12,7,19
9049,40,2011-08-22 19:47:56.482-04,12,1,13
9050,41,2011-08-22 19:47:56.482-04,19,0,19
9051,42,2011-08-22 19:47:56.482-04,2,17,19
9052,43,2011-08-22 19:47:56.482-04,3,12,15
9053,44,2011-08-22 19:47:56.482-04,15,4,19
9054,45,2011-08-22 19:47:56.482-04,8,11,19
9055,46,2011-08-22 19:47:56.482-04,11,8,19
9056,47,2011-08-22 19:47:56.482-04,11,0,11
9057,48,2011-08-22 19:47:56.482-04,0,15,15
9058,49,2011-08-22 19:47:56.482-04,9,6,15
9059,50,2011-08-22 19:47:56.482-04,0,15,15
9060,51,2011-08-22 19:47:56.482-04,6,9,15
9061,52,2011-08-22 19:47:56.482-04,9,5,14
9062,53,2011-08-22 19:47:56.482-04,15,0,15
9063,55,2011-08-22 19:47:56.482-04,7,8,15
9064,56,2011-08-22 19:47:56.482-04,4,11,15
9065,57,2011-08-22 19:47:56.482-04,4,7,11
9066,3,2011-08-22 19:48:57.32-04,9,8,17
9067,5,2011-08-22 19:48:57.32-04,7,8,15
9068,6,2011-08-22 19:48:57.32-04,13,2,15
9069,8,2011-08-22 19:48:57.32-04,5,10,15
9070,9,2011-08-22 19:48:57.32-04,9,10,19
9071,10,2011-08-22 19:48:57.32-04,4,15,19
9072,11,2011-08-22 19:48:57.32-04,0,15,15
9073,12,2011-08-22 19:48:57.32-04,12,3,15
9074,13,2011-08-22 19:48:57.32-04,7,8,15
9075,14,2011-08-22 19:48:57.32-04,4,13,17
9076,15,2011-08-22 19:48:57.32-04,4,11,15
9077,16,2011-08-22 19:48:57.32-04,8,11,19
9078,17,2011-08-22 19:48:57.32-04,4,11,15
9079,18,2011-08-22 19:48:57.32-04,9,6,15
9080,20,2011-08-22 19:48:57.32-04,15,4,19
9081,21,2011-08-22 19:48:57.32-04,5,18,23
9082,22,2011-08-22 19:48:57.32-04,19,28,47
9083,23,2011-08-22 19:48:57.32-04,1,17,18
9084,24,2011-08-22 19:48:57.32-04,2,13,15
9085,25,2011-08-22 19:48:57.32-04,6,9,15
9086,26,2011-08-22 19:48:57.32-04,8,7,15
9087,27,2011-08-22 19:48:57.32-04,5,9,14
9088,30,2011-08-22 19:48:57.32-04,11,4,15
9089,31,2011-08-22 19:48:57.32-04,4,7,11
9090,32,2011-08-22 19:48:57.32-04,9,2,11
9091,33,2011-08-22 19:48:57.32-04,7,12,19
9092,34,2011-08-22 19:48:57.32-04,8,7,15
9093,35,2011-08-22 19:48:57.32-04,2,9,11
9094,36,2011-08-22 19:48:57.32-04,0,15,15
9095,37,2011-08-22 19:48:57.32-04,8,7,15
9096,38,2011-08-22 19:48:57.32-04,32,3,35
9097,39,2011-08-22 19:48:57.32-04,12,7,19
9098,40,2011-08-22 19:48:57.32-04,12,1,13
9099,41,2011-08-22 19:48:57.32-04,19,0,19
9100,42,2011-08-22 19:48:57.32-04,2,17,19
9101,43,2011-08-22 19:48:57.32-04,3,12,15
9102,44,2011-08-22 19:48:57.32-04,15,4,19
9103,45,2011-08-22 19:48:57.32-04,8,11,19
9104,46,2011-08-22 19:48:57.32-04,11,8,19
9105,47,2011-08-22 19:48:57.32-04,11,0,11
9106,48,2011-08-22 19:48:57.32-04,0,15,15
9107,49,2011-08-22 19:48:57.32-04,9,6,15
9108,50,2011-08-22 19:48:57.32-04,0,15,15
9109,51,2011-08-22 19:48:57.32-04,6,9,15
9110,52,2011-08-22 19:48:57.32-04,9,5,14
9111,53,2011-08-22 19:48:57.32-04,15,0,15
9112,55,2011-08-22 19:48:57.32-04,7,8,15
9113,56,2011-08-22 19:48:57.32-04,5,10,15
9114,57,2011-08-22 19:48:57.32-04,4,7,11
9115,3,2011-08-22 19:49:58.202-04,9,8,17
9116,5,2011-08-22 19:49:58.202-04,8,7,15
9117,6,2011-08-22 19:49:58.202-04,13,2,15
9118,8,2011-08-22 19:49:58.202-04,5,10,15
9119,9,2011-08-22 19:49:58.202-04,9,10,19
9120,10,2011-08-22 19:49:58.202-04,4,15,19
9121,11,2011-08-22 19:49:58.202-04,0,15,15
9122,12,2011-08-22 19:49:58.202-04,12,3,15
9123,13,2011-08-22 19:49:58.202-04,7,8,15
9124,14,2011-08-22 19:49:58.202-04,4,13,17
9125,15,2011-08-22 19:49:58.202-04,4,11,15
9126,16,2011-08-22 19:49:58.202-04,8,11,19
9127,17,2011-08-22 19:49:58.202-04,4,11,15
9128,18,2011-08-22 19:49:58.202-04,9,6,15
9129,20,2011-08-22 19:49:58.202-04,15,4,19
9130,21,2011-08-22 19:49:58.202-04,5,18,23
9131,22,2011-08-22 19:49:58.202-04,19,28,47
9132,23,2011-08-22 19:49:58.202-04,2,16,18
9133,24,2011-08-22 19:49:58.202-04,1,14,15
9134,25,2011-08-22 19:49:58.202-04,6,9,15
9135,26,2011-08-22 19:49:58.202-04,8,7,15
9136,27,2011-08-22 19:49:58.202-04,5,9,14
9137,30,2011-08-22 19:49:58.202-04,11,4,15
9138,31,2011-08-22 19:49:58.202-04,4,7,11
9139,32,2011-08-22 19:49:58.202-04,9,2,11
9140,33,2011-08-22 19:49:58.202-04,7,12,19
9141,34,2011-08-22 19:49:58.202-04,8,7,15
9142,35,2011-08-22 19:49:58.202-04,2,9,11
9143,36,2011-08-22 19:49:58.202-04,0,15,15
9144,37,2011-08-22 19:49:58.202-04,8,7,15
9145,38,2011-08-22 19:49:58.202-04,32,3,35
9146,39,2011-08-22 19:49:58.202-04,12,7,19
9147,40,2011-08-22 19:49:58.202-04,12,1,13
9148,41,2011-08-22 19:49:58.202-04,19,0,19
9149,42,2011-08-22 19:49:58.202-04,2,17,19
9150,43,2011-08-22 19:49:58.202-04,3,12,15
9151,44,2011-08-22 19:49:58.202-04,15,4,19
9152,45,2011-08-22 19:49:58.202-04,8,11,19
9153,46,2011-08-22 19:49:58.202-04,11,8,19
9154,47,2011-08-22 19:49:58.202-04,11,0,11
9155,48,2011-08-22 19:49:58.202-04,0,15,15
9156,49,2011-08-22 19:49:58.202-04,9,6,15
9157,50,2011-08-22 19:49:58.202-04,0,15,15
9158,51,2011-08-22 19:49:58.202-04,6,9,15
9159,52,2011-08-22 19:49:58.202-04,9,5,14
9160,53,2011-08-22 19:49:58.202-04,15,0,15
9161,55,2011-08-22 19:49:58.202-04,7,8,15
9162,56,2011-08-22 19:49:58.202-04,5,10,15
9163,57,2011-08-22 19:49:58.202-04,4,7,11
9164,3,2011-08-22 19:50:59.079-04,9,8,17
9165,5,2011-08-22 19:50:59.079-04,8,7,15
9166,6,2011-08-22 19:50:59.079-04,13,2,15
9167,8,2011-08-22 19:50:59.079-04,5,10,15
9168,9,2011-08-22 19:50:59.079-04,9,10,19
9169,10,2011-08-22 19:50:59.079-04,4,15,19
9170,11,2011-08-22 19:50:59.079-04,0,15,15
9171,12,2011-08-22 19:50:59.079-04,12,3,15
9172,13,2011-08-22 19:50:59.079-04,7,8,15
9173,14,2011-08-22 19:50:59.079-04,4,13,17
9174,15,2011-08-22 19:50:59.079-04,4,11,15
9175,16,2011-08-22 19:50:59.079-04,8,11,19
9176,17,2011-08-22 19:50:59.079-04,3,12,15
9177,18,2011-08-22 19:50:59.079-04,9,6,15
9178,20,2011-08-22 19:50:59.079-04,15,4,19
9179,21,2011-08-22 19:50:59.079-04,5,18,23
9180,22,2011-08-22 19:50:59.079-04,19,28,47
9181,23,2011-08-22 19:50:59.079-04,2,16,18
9182,24,2011-08-22 19:50:59.079-04,1,14,15
9183,25,2011-08-22 19:50:59.079-04,6,9,15
9184,26,2011-08-22 19:50:59.079-04,8,7,15
9185,27,2011-08-22 19:50:59.079-04,5,9,14
9186,30,2011-08-22 19:50:59.079-04,11,4,15
9187,31,2011-08-22 19:50:59.079-04,4,7,11
9188,32,2011-08-22 19:50:59.079-04,9,2,11
9189,33,2011-08-22 19:50:59.079-04,7,12,19
9190,34,2011-08-22 19:50:59.079-04,8,7,15
9191,35,2011-08-22 19:50:59.079-04,2,9,11
9192,36,2011-08-22 19:50:59.079-04,0,15,15
9193,37,2011-08-22 19:50:59.079-04,8,7,15
9194,38,2011-08-22 19:50:59.079-04,32,3,35
9195,39,2011-08-22 19:50:59.079-04,12,7,19
9196,40,2011-08-22 19:50:59.079-04,12,1,13
9197,41,2011-08-22 19:50:59.079-04,19,0,19
9198,42,2011-08-22 19:50:59.079-04,2,17,19
9199,43,2011-08-22 19:50:59.079-04,3,12,15
9200,44,2011-08-22 19:50:59.079-04,15,4,19
9201,45,2011-08-22 19:50:59.079-04,8,11,19
9202,46,2011-08-22 19:50:59.079-04,11,8,19
9203,47,2011-08-22 19:50:59.079-04,11,0,11
9204,48,2011-08-22 19:50:59.079-04,0,15,15
9205,49,2011-08-22 19:50:59.079-04,10,5,15
9206,50,2011-08-22 19:50:59.079-04,0,15,15
9207,51,2011-08-22 19:50:59.079-04,6,9,15
9208,52,2011-08-22 19:50:59.079-04,9,5,14
9209,53,2011-08-22 19:50:59.079-04,14,1,15
9210,55,2011-08-22 19:50:59.079-04,7,8,15
9211,56,2011-08-22 19:50:59.079-04,5,10,15
9212,57,2011-08-22 19:50:59.079-04,4,7,11
9213,3,2011-08-22 19:51:59.982-04,9,8,17
9214,5,2011-08-22 19:51:59.982-04,8,7,15
9215,6,2011-08-22 19:51:59.982-04,13,2,15
9216,8,2011-08-22 19:51:59.982-04,5,10,15
9217,9,2011-08-22 19:51:59.982-04,9,10,19
9218,10,2011-08-22 19:51:59.982-04,4,15,19
9219,11,2011-08-22 19:51:59.982-04,0,15,15
9220,12,2011-08-22 19:51:59.982-04,12,3,15
9221,13,2011-08-22 19:51:59.982-04,7,8,15
9222,14,2011-08-22 19:51:59.982-04,4,13,17
9223,15,2011-08-22 19:51:59.982-04,4,11,15
9224,16,2011-08-22 19:51:59.982-04,8,11,19
9225,17,2011-08-22 19:51:59.982-04,3,12,15
9226,18,2011-08-22 19:51:59.982-04,9,6,15
9227,20,2011-08-22 19:51:59.982-04,16,3,19
9228,21,2011-08-22 19:51:59.982-04,5,18,23
9229,22,2011-08-22 19:51:59.982-04,19,28,47
9230,23,2011-08-22 19:51:59.982-04,0,18,18
9231,24,2011-08-22 19:51:59.982-04,1,14,15
9232,25,2011-08-22 19:51:59.982-04,6,9,15
9233,26,2011-08-22 19:51:59.982-04,8,7,15
9234,27,2011-08-22 19:51:59.982-04,5,9,14
9235,30,2011-08-22 19:51:59.982-04,11,4,15
9236,31,2011-08-22 19:51:59.982-04,4,7,11
9237,32,2011-08-22 19:51:59.982-04,9,2,11
9238,33,2011-08-22 19:51:59.982-04,8,11,19
9239,34,2011-08-22 19:51:59.982-04,8,7,15
9240,35,2011-08-22 19:51:59.982-04,2,9,11
9241,36,2011-08-22 19:51:59.982-04,0,15,15
9242,37,2011-08-22 19:51:59.982-04,8,7,15
9243,38,2011-08-22 19:51:59.982-04,32,3,35
9244,39,2011-08-22 19:51:59.982-04,12,7,19
9245,40,2011-08-22 19:51:59.982-04,12,1,13
9246,41,2011-08-22 19:51:59.982-04,19,0,19
9247,42,2011-08-22 19:51:59.982-04,2,17,19
9248,43,2011-08-22 19:51:59.982-04,3,12,15
9249,44,2011-08-22 19:51:59.982-04,15,4,19
9250,45,2011-08-22 19:51:59.982-04,8,11,19
9251,46,2011-08-22 19:51:59.982-04,11,8,19
9252,47,2011-08-22 19:51:59.982-04,11,0,11
9253,48,2011-08-22 19:51:59.982-04,0,15,15
9254,49,2011-08-22 19:51:59.982-04,11,4,15
9255,50,2011-08-22 19:51:59.982-04,0,15,15
9256,51,2011-08-22 19:51:59.982-04,6,9,15
9257,52,2011-08-22 19:51:59.982-04,9,5,14
9258,53,2011-08-22 19:51:59.982-04,14,1,15
9259,55,2011-08-22 19:51:59.982-04,7,8,15
9260,56,2011-08-22 19:51:59.982-04,5,10,15
9261,57,2011-08-22 19:51:59.982-04,4,7,11
9262,3,2011-08-22 19:53:00.977-04,9,8,17
9263,5,2011-08-22 19:53:00.977-04,8,7,15
9264,6,2011-08-22 19:53:00.977-04,13,2,15
9265,8,2011-08-22 19:53:00.977-04,5,10,15
9266,9,2011-08-22 19:53:00.977-04,9,10,19
9267,10,2011-08-22 19:53:00.977-04,3,16,19
9268,11,2011-08-22 19:53:00.977-04,0,15,15
9269,12,2011-08-22 19:53:00.977-04,12,3,15
9270,13,2011-08-22 19:53:00.977-04,7,8,15
9271,14,2011-08-22 19:53:00.977-04,4,13,17
9272,15,2011-08-22 19:53:00.977-04,4,11,15
9273,16,2011-08-22 19:53:00.977-04,8,11,19
9274,17,2011-08-22 19:53:00.977-04,3,12,15
9275,18,2011-08-22 19:53:00.977-04,9,6,15
9276,20,2011-08-22 19:53:00.977-04,16,3,19
9277,21,2011-08-22 19:53:00.977-04,6,17,23
9278,22,2011-08-22 19:53:00.977-04,19,28,47
9279,23,2011-08-22 19:53:00.977-04,0,18,18
9280,24,2011-08-22 19:53:00.977-04,1,14,15
9281,25,2011-08-22 19:53:00.977-04,6,9,15
9282,26,2011-08-22 19:53:00.977-04,8,7,15
9283,27,2011-08-22 19:53:00.977-04,5,9,14
9284,30,2011-08-22 19:53:00.977-04,11,4,15
9285,31,2011-08-22 19:53:00.977-04,4,7,11
9286,32,2011-08-22 19:53:00.977-04,9,2,11
9287,33,2011-08-22 19:53:00.977-04,8,11,19
9288,34,2011-08-22 19:53:00.977-04,8,7,15
9289,35,2011-08-22 19:53:00.977-04,2,9,11
9290,36,2011-08-22 19:53:00.977-04,0,15,15
9291,37,2011-08-22 19:53:00.977-04,8,7,15
9292,38,2011-08-22 19:53:00.977-04,32,3,35
9293,39,2011-08-22 19:53:00.977-04,13,6,19
9294,40,2011-08-22 19:53:00.977-04,12,1,13
9295,41,2011-08-22 19:53:00.977-04,18,1,19
9296,42,2011-08-22 19:53:00.977-04,2,17,19
9297,43,2011-08-22 19:53:00.977-04,3,12,15
9298,44,2011-08-22 19:53:00.977-04,15,4,19
9299,45,2011-08-22 19:53:00.977-04,8,11,19
9300,46,2011-08-22 19:53:00.977-04,11,8,19
9301,47,2011-08-22 19:53:00.977-04,11,0,11
9302,48,2011-08-22 19:53:00.977-04,0,15,15
9303,49,2011-08-22 19:53:00.977-04,11,4,15
9304,50,2011-08-22 19:53:00.977-04,0,15,15
9305,51,2011-08-22 19:53:00.977-04,6,9,15
9306,52,2011-08-22 19:53:00.977-04,9,5,14
9307,53,2011-08-22 19:53:00.977-04,14,1,15
9308,55,2011-08-22 19:53:00.977-04,7,8,15
9309,56,2011-08-22 19:53:00.977-04,5,10,15
9310,57,2011-08-22 19:53:00.977-04,4,7,11
9311,3,2011-08-22 19:54:01.875-04,9,8,17
9312,5,2011-08-22 19:54:01.875-04,8,7,15
9313,6,2011-08-22 19:54:01.875-04,13,2,15
9314,8,2011-08-22 19:54:01.875-04,5,10,15
9315,9,2011-08-22 19:54:01.875-04,9,10,19
9316,10,2011-08-22 19:54:01.875-04,3,16,19
9317,11,2011-08-22 19:54:01.875-04,0,15,15
9318,12,2011-08-22 19:54:01.875-04,12,3,15
9319,13,2011-08-22 19:54:01.875-04,7,8,15
9320,14,2011-08-22 19:54:01.875-04,4,13,17
9321,15,2011-08-22 19:54:01.875-04,4,11,15
9322,16,2011-08-22 19:54:01.875-04,8,11,19
9323,17,2011-08-22 19:54:01.875-04,3,12,15
9324,18,2011-08-22 19:54:01.875-04,9,6,15
9325,20,2011-08-22 19:54:01.875-04,16,3,19
9326,21,2011-08-22 19:54:01.875-04,6,17,23
9327,22,2011-08-22 19:54:01.875-04,19,28,47
9328,23,2011-08-22 19:54:01.875-04,0,18,18
9329,24,2011-08-22 19:54:01.875-04,1,14,15
9330,25,2011-08-22 19:54:01.875-04,6,9,15
9331,26,2011-08-22 19:54:01.875-04,8,7,15
9332,27,2011-08-22 19:54:01.875-04,5,9,14
9333,30,2011-08-22 19:54:01.875-04,11,4,15
9334,31,2011-08-22 19:54:01.875-04,4,7,11
9335,32,2011-08-22 19:54:01.875-04,9,2,11
9336,33,2011-08-22 19:54:01.875-04,8,11,19
9337,34,2011-08-22 19:54:01.875-04,8,7,15
9338,35,2011-08-22 19:54:01.875-04,2,9,11
9339,36,2011-08-22 19:54:01.875-04,0,15,15
9340,37,2011-08-22 19:54:01.875-04,8,7,15
9341,38,2011-08-22 19:54:01.875-04,32,3,35
9342,39,2011-08-22 19:54:01.875-04,13,6,19
9343,40,2011-08-22 19:54:01.875-04,12,1,13
9344,41,2011-08-22 19:54:01.875-04,18,1,19
9345,42,2011-08-22 19:54:01.875-04,2,17,19
9346,43,2011-08-22 19:54:01.875-04,3,12,15
9347,44,2011-08-22 19:54:01.875-04,15,4,19
9348,45,2011-08-22 19:54:01.875-04,8,11,19
9349,46,2011-08-22 19:54:01.875-04,11,8,19
9350,47,2011-08-22 19:54:01.875-04,11,0,11
9351,48,2011-08-22 19:54:01.875-04,0,15,15
9352,49,2011-08-22 19:54:01.875-04,11,4,15
9353,50,2011-08-22 19:54:01.875-04,0,15,15
9354,51,2011-08-22 19:54:01.875-04,6,9,15
9355,52,2011-08-22 19:54:01.875-04,9,5,14
9356,53,2011-08-22 19:54:01.875-04,14,1,15
9357,55,2011-08-22 19:54:01.875-04,7,8,15
9358,56,2011-08-22 19:54:01.875-04,6,9,15
9359,57,2011-08-22 19:54:01.875-04,4,7,11
9360,3,2011-08-22 19:55:02.816-04,9,8,17
9361,5,2011-08-22 19:55:02.816-04,8,7,15
9362,6,2011-08-22 19:55:02.816-04,13,2,15
9363,8,2011-08-22 19:55:02.816-04,5,10,15
9364,9,2011-08-22 19:55:02.816-04,9,10,19
9365,10,2011-08-22 19:55:02.816-04,3,16,19
9366,11,2011-08-22 19:55:02.816-04,1,14,15
9367,12,2011-08-22 19:55:02.816-04,12,3,15
9368,13,2011-08-22 19:55:02.816-04,7,8,15
9369,14,2011-08-22 19:55:02.816-04,4,13,17
9370,15,2011-08-22 19:55:02.816-04,4,11,15
9371,16,2011-08-22 19:55:02.816-04,8,11,19
9372,17,2011-08-22 19:55:02.816-04,3,12,15
9373,18,2011-08-22 19:55:02.816-04,9,6,15
9374,20,2011-08-22 19:55:02.816-04,16,3,19
9375,21,2011-08-22 19:55:02.816-04,6,17,23
9376,22,2011-08-22 19:55:02.816-04,19,28,47
9377,23,2011-08-22 19:55:02.816-04,0,18,18
9378,24,2011-08-22 19:55:02.816-04,1,14,15
9379,25,2011-08-22 19:55:02.816-04,7,8,15
9380,26,2011-08-22 19:55:02.816-04,8,7,15
9381,27,2011-08-22 19:55:02.816-04,5,9,14
9382,30,2011-08-22 19:55:02.816-04,11,4,15
9383,31,2011-08-22 19:55:02.816-04,4,7,11
9384,32,2011-08-22 19:55:02.816-04,9,2,11
9385,33,2011-08-22 19:55:02.816-04,8,11,19
9386,34,2011-08-22 19:55:02.816-04,8,7,15
9387,35,2011-08-22 19:55:02.816-04,2,9,11
9388,36,2011-08-22 19:55:02.816-04,0,15,15
9389,37,2011-08-22 19:55:02.816-04,8,7,15
9390,38,2011-08-22 19:55:02.816-04,32,3,35
9391,39,2011-08-22 19:55:02.816-04,12,7,19
9392,40,2011-08-22 19:55:02.816-04,12,1,13
9393,41,2011-08-22 19:55:02.816-04,18,1,19
9394,42,2011-08-22 19:55:02.816-04,2,17,19
9395,43,2011-08-22 19:55:02.816-04,3,12,15
9396,44,2011-08-22 19:55:02.816-04,15,4,19
9397,45,2011-08-22 19:55:02.816-04,8,11,19
9398,46,2011-08-22 19:55:02.816-04,11,8,19
9399,47,2011-08-22 19:55:02.816-04,11,0,11
9400,48,2011-08-22 19:55:02.816-04,0,15,15
9401,49,2011-08-22 19:55:02.816-04,11,4,15
9402,50,2011-08-22 19:55:02.816-04,0,15,15
9403,51,2011-08-22 19:55:02.816-04,6,9,15
9404,52,2011-08-22 19:55:02.816-04,9,5,14
9405,53,2011-08-22 19:55:02.816-04,14,1,15
9406,55,2011-08-22 19:55:02.816-04,7,8,15
9407,56,2011-08-22 19:55:02.816-04,6,9,15
9408,57,2011-08-22 19:55:02.816-04,4,7,11
9409,3,2011-08-22 19:56:03.67-04,9,8,17
9410,5,2011-08-22 19:56:03.67-04,8,7,15
9411,6,2011-08-22 19:56:03.67-04,13,2,15
9412,8,2011-08-22 19:56:03.67-04,5,10,15
9413,9,2011-08-22 19:56:03.67-04,9,10,19
9414,10,2011-08-22 19:56:03.67-04,3,16,19
9415,11,2011-08-22 19:56:03.67-04,1,14,15
9416,12,2011-08-22 19:56:03.67-04,12,3,15
9417,13,2011-08-22 19:56:03.67-04,7,8,15
9418,14,2011-08-22 19:56:03.67-04,4,13,17
9419,15,2011-08-22 19:56:03.67-04,4,11,15
9420,16,2011-08-22 19:56:03.67-04,8,11,19
9421,17,2011-08-22 19:56:03.67-04,3,12,15
9422,18,2011-08-22 19:56:03.67-04,9,6,15
9423,20,2011-08-22 19:56:03.67-04,16,3,19
9424,21,2011-08-22 19:56:03.67-04,6,17,23
9425,22,2011-08-22 19:56:03.67-04,19,28,47
9426,23,2011-08-22 19:56:03.67-04,0,18,18
9427,24,2011-08-22 19:56:03.67-04,1,14,15
9428,25,2011-08-22 19:56:03.67-04,8,7,15
9429,26,2011-08-22 19:56:03.67-04,8,7,15
9430,27,2011-08-22 19:56:03.67-04,5,9,14
9431,30,2011-08-22 19:56:03.67-04,11,4,15
9432,31,2011-08-22 19:56:03.67-04,4,7,11
9433,32,2011-08-22 19:56:03.67-04,9,2,11
9434,33,2011-08-22 19:56:03.67-04,8,11,19
9435,34,2011-08-22 19:56:03.67-04,8,7,15
9436,35,2011-08-22 19:56:03.67-04,2,9,11
9437,36,2011-08-22 19:56:03.67-04,0,15,15
9438,37,2011-08-22 19:56:03.67-04,8,7,15
9439,38,2011-08-22 19:56:03.67-04,32,3,35
9440,39,2011-08-22 19:56:03.67-04,12,7,19
9441,40,2011-08-22 19:56:03.67-04,12,1,13
9442,41,2011-08-22 19:56:03.67-04,18,1,19
9443,42,2011-08-22 19:56:03.67-04,2,17,19
9444,43,2011-08-22 19:56:03.67-04,3,12,15
9445,44,2011-08-22 19:56:03.67-04,15,4,19
9446,45,2011-08-22 19:56:03.67-04,8,11,19
9447,46,2011-08-22 19:56:03.67-04,11,8,19
9448,47,2011-08-22 19:56:03.67-04,11,0,11
9449,48,2011-08-22 19:56:03.67-04,0,15,15
9450,49,2011-08-22 19:56:03.67-04,11,4,15
9451,50,2011-08-22 19:56:03.67-04,0,15,15
9452,51,2011-08-22 19:56:03.67-04,6,9,15
9453,52,2011-08-22 19:56:03.67-04,9,5,14
9454,53,2011-08-22 19:56:03.67-04,14,1,15
9455,55,2011-08-22 19:56:03.67-04,7,8,15
9456,56,2011-08-22 19:56:03.67-04,6,9,15
9457,57,2011-08-22 19:56:03.67-04,4,7,11
9458,3,2011-08-22 19:57:04.553-04,9,8,17
9459,5,2011-08-22 19:57:04.553-04,8,7,15
9460,6,2011-08-22 19:57:04.553-04,13,2,15
9461,8,2011-08-22 19:57:04.553-04,5,10,15
9462,9,2011-08-22 19:57:04.553-04,9,10,19
9463,10,2011-08-22 19:57:04.553-04,3,16,19
9464,11,2011-08-22 19:57:04.553-04,3,12,15
9465,12,2011-08-22 19:57:04.553-04,12,3,15
9466,13,2011-08-22 19:57:04.553-04,7,8,15
9467,14,2011-08-22 19:57:04.553-04,4,13,17
9468,15,2011-08-22 19:57:04.553-04,4,11,15
9469,16,2011-08-22 19:57:04.553-04,8,11,19
9470,17,2011-08-22 19:57:04.553-04,3,12,15
9471,18,2011-08-22 19:57:04.553-04,9,6,15
9472,20,2011-08-22 19:57:04.553-04,16,3,19
9473,21,2011-08-22 19:57:04.553-04,6,17,23
9474,22,2011-08-22 19:57:04.553-04,19,28,47
9475,23,2011-08-22 19:57:04.553-04,0,18,18
9476,24,2011-08-22 19:57:04.553-04,1,14,15
9477,25,2011-08-22 19:57:04.553-04,8,7,15
9478,26,2011-08-22 19:57:04.553-04,8,7,15
9479,27,2011-08-22 19:57:04.553-04,6,8,14
9480,30,2011-08-22 19:57:04.553-04,11,4,15
9481,31,2011-08-22 19:57:04.553-04,4,7,11
9482,32,2011-08-22 19:57:04.553-04,9,2,11
9483,33,2011-08-22 19:57:04.553-04,8,11,19
9484,34,2011-08-22 19:57:04.553-04,8,7,15
9485,35,2011-08-22 19:57:04.553-04,2,9,11
9486,36,2011-08-22 19:57:04.553-04,0,15,15
9487,37,2011-08-22 19:57:04.553-04,8,7,15
9488,38,2011-08-22 19:57:04.553-04,33,2,35
9489,39,2011-08-22 19:57:04.553-04,12,7,19
9490,40,2011-08-22 19:57:04.553-04,12,1,13
9491,41,2011-08-22 19:57:04.553-04,18,1,19
9492,42,2011-08-22 19:57:04.553-04,2,17,19
9493,43,2011-08-22 19:57:04.553-04,3,12,15
9494,44,2011-08-22 19:57:04.553-04,15,4,19
9495,45,2011-08-22 19:57:04.553-04,8,11,19
9496,46,2011-08-22 19:57:04.553-04,11,8,19
9497,47,2011-08-22 19:57:04.553-04,11,0,11
9498,48,2011-08-22 19:57:04.553-04,0,15,15
9499,49,2011-08-22 19:57:04.553-04,11,4,15
9500,50,2011-08-22 19:57:04.553-04,0,15,15
9501,51,2011-08-22 19:57:04.553-04,6,9,15
9502,52,2011-08-22 19:57:04.553-04,9,5,14
9503,53,2011-08-22 19:57:04.553-04,14,1,15
9504,55,2011-08-22 19:57:04.553-04,7,8,15
9505,56,2011-08-22 19:57:04.553-04,6,9,15
9506,57,2011-08-22 19:57:04.553-04,4,7,11
9507,3,2011-08-22 19:58:05.597-04,9,8,17
9508,5,2011-08-22 19:58:05.597-04,6,9,15
9509,6,2011-08-22 19:58:05.597-04,13,2,15
9510,8,2011-08-22 19:58:05.597-04,5,10,15
9511,9,2011-08-22 19:58:05.597-04,9,10,19
9512,10,2011-08-22 19:58:05.597-04,3,16,19
9513,11,2011-08-22 19:58:05.597-04,5,10,15
9514,12,2011-08-22 19:58:05.597-04,12,3,15
9515,13,2011-08-22 19:58:05.597-04,7,8,15
9516,14,2011-08-22 19:58:05.597-04,4,13,17
9517,15,2011-08-22 19:58:05.597-04,4,11,15
9518,16,2011-08-22 19:58:05.597-04,8,11,19
9519,17,2011-08-22 19:58:05.597-04,3,12,15
9520,18,2011-08-22 19:58:05.597-04,9,6,15
9521,20,2011-08-22 19:58:05.597-04,16,3,19
9522,21,2011-08-22 19:58:05.597-04,6,17,23
9523,22,2011-08-22 19:58:05.597-04,19,28,47
9524,23,2011-08-22 19:58:05.597-04,0,18,18
9525,24,2011-08-22 19:58:05.597-04,1,14,15
9526,25,2011-08-22 19:58:05.597-04,9,6,15
9527,26,2011-08-22 19:58:05.597-04,8,7,15
9528,27,2011-08-22 19:58:05.597-04,6,8,14
9529,30,2011-08-22 19:58:05.597-04,11,4,15
9530,31,2011-08-22 19:58:05.597-04,4,7,11
9531,32,2011-08-22 19:58:05.597-04,9,2,11
9532,33,2011-08-22 19:58:05.597-04,8,11,19
9533,34,2011-08-22 19:58:05.597-04,8,7,15
9534,35,2011-08-22 19:58:05.597-04,2,9,11
9535,36,2011-08-22 19:58:05.597-04,0,15,15
9536,37,2011-08-22 19:58:05.597-04,8,7,15
9537,38,2011-08-22 19:58:05.597-04,33,2,35
9538,39,2011-08-22 19:58:05.597-04,12,7,19
9539,40,2011-08-22 19:58:05.597-04,12,1,13
9540,41,2011-08-22 19:58:05.597-04,18,1,19
9541,42,2011-08-22 19:58:05.597-04,2,17,19
9542,43,2011-08-22 19:58:05.597-04,3,12,15
9543,44,2011-08-22 19:58:05.597-04,15,4,19
9544,45,2011-08-22 19:58:05.597-04,8,11,19
9545,46,2011-08-22 19:58:05.597-04,11,8,19
9546,47,2011-08-22 19:58:05.597-04,11,0,11
9547,48,2011-08-22 19:58:05.597-04,0,15,15
9548,49,2011-08-22 19:58:05.597-04,11,4,15
9549,50,2011-08-22 19:58:05.597-04,0,15,15
9550,51,2011-08-22 19:58:05.597-04,6,9,15
9551,52,2011-08-22 19:58:05.597-04,9,5,14
9552,53,2011-08-22 19:58:05.597-04,14,1,15
9553,55,2011-08-22 19:58:05.597-04,7,8,15
9554,56,2011-08-22 19:58:05.597-04,6,9,15
9555,57,2011-08-22 19:58:05.597-04,4,7,11
9556,3,2011-08-22 19:59:06.502-04,9,8,17
9557,5,2011-08-22 19:59:06.502-04,6,9,15
9558,6,2011-08-22 19:59:06.502-04,13,2,15
9559,8,2011-08-22 19:59:06.502-04,5,10,15
9560,9,2011-08-22 19:59:06.502-04,9,10,19
9561,10,2011-08-22 19:59:06.502-04,3,16,19
9562,11,2011-08-22 19:59:06.502-04,5,10,15
9563,12,2011-08-22 19:59:06.502-04,12,3,15
9564,13,2011-08-22 19:59:06.502-04,7,8,15
9565,14,2011-08-22 19:59:06.502-04,4,13,17
9566,15,2011-08-22 19:59:06.502-04,4,11,15
9567,16,2011-08-22 19:59:06.502-04,8,11,19
9568,17,2011-08-22 19:59:06.502-04,3,12,15
9569,18,2011-08-22 19:59:06.502-04,9,6,15
9570,20,2011-08-22 19:59:06.502-04,16,3,19
9571,21,2011-08-22 19:59:06.502-04,6,17,23
9572,22,2011-08-22 19:59:06.502-04,19,28,47
9573,23,2011-08-22 19:59:06.502-04,0,18,18
9574,24,2011-08-22 19:59:06.502-04,1,14,15
9575,25,2011-08-22 19:59:06.502-04,9,6,15
9576,26,2011-08-22 19:59:06.502-04,8,7,15
9577,27,2011-08-22 19:59:06.502-04,6,8,14
9578,30,2011-08-22 19:59:06.502-04,11,4,15
9579,31,2011-08-22 19:59:06.502-04,4,7,11
9580,32,2011-08-22 19:59:06.502-04,9,2,11
9581,33,2011-08-22 19:59:06.502-04,8,11,19
9582,34,2011-08-22 19:59:06.502-04,8,7,15
9583,35,2011-08-22 19:59:06.502-04,2,9,11
9584,36,2011-08-22 19:59:06.502-04,0,15,15
9585,37,2011-08-22 19:59:06.502-04,8,7,15
9586,38,2011-08-22 19:59:06.502-04,33,2,35
9587,39,2011-08-22 19:59:06.502-04,12,7,19
9588,40,2011-08-22 19:59:06.502-04,12,1,13
9589,41,2011-08-22 19:59:06.502-04,18,1,19
9590,42,2011-08-22 19:59:06.502-04,2,17,19
9591,43,2011-08-22 19:59:06.502-04,3,12,15
9592,44,2011-08-22 19:59:06.502-04,15,4,19
9593,45,2011-08-22 19:59:06.502-04,8,11,19
9594,46,2011-08-22 19:59:06.502-04,11,8,19
9595,47,2011-08-22 19:59:06.502-04,11,0,11
9596,48,2011-08-22 19:59:06.502-04,0,15,15
9597,49,2011-08-22 19:59:06.502-04,11,4,15
9598,50,2011-08-22 19:59:06.502-04,0,15,15
9599,51,2011-08-22 19:59:06.502-04,6,9,15
9600,52,2011-08-22 19:59:06.502-04,9,5,14
9601,53,2011-08-22 19:59:06.502-04,14,1,15
9602,55,2011-08-22 19:59:06.502-04,7,8,15
9603,56,2011-08-22 19:59:06.502-04,6,9,15
9604,57,2011-08-22 19:59:06.502-04,4,7,11
9605,3,2011-08-22 20:00:07.343-04,9,8,17
9606,5,2011-08-22 20:00:07.343-04,6,9,15
9607,6,2011-08-22 20:00:07.343-04,13,2,15
9608,8,2011-08-22 20:00:07.343-04,5,10,15
9609,9,2011-08-22 20:00:07.343-04,9,10,19
9610,10,2011-08-22 20:00:07.343-04,3,16,19
9611,11,2011-08-22 20:00:07.343-04,6,9,15
9612,12,2011-08-22 20:00:07.343-04,12,3,15
9613,13,2011-08-22 20:00:07.343-04,7,8,15
9614,14,2011-08-22 20:00:07.343-04,4,13,17
9615,15,2011-08-22 20:00:07.343-04,4,11,15
9616,16,2011-08-22 20:00:07.343-04,8,11,19
9617,17,2011-08-22 20:00:07.343-04,3,12,15
9618,18,2011-08-22 20:00:07.343-04,9,6,15
9619,20,2011-08-22 20:00:07.343-04,16,3,19
9620,21,2011-08-22 20:00:07.343-04,6,17,23
9621,22,2011-08-22 20:00:07.343-04,19,28,47
9622,23,2011-08-22 20:00:07.343-04,1,17,18
9623,24,2011-08-22 20:00:07.343-04,1,14,15
9624,25,2011-08-22 20:00:07.343-04,9,6,15
9625,26,2011-08-22 20:00:07.343-04,8,7,15
9626,27,2011-08-22 20:00:07.343-04,6,8,14
9627,30,2011-08-22 20:00:07.343-04,11,4,15
9628,31,2011-08-22 20:00:07.343-04,4,7,11
9629,32,2011-08-22 20:00:07.343-04,9,2,11
9630,33,2011-08-22 20:00:07.343-04,8,11,19
9631,34,2011-08-22 20:00:07.343-04,8,7,15
9632,35,2011-08-22 20:00:07.343-04,2,9,11
9633,36,2011-08-22 20:00:07.343-04,0,15,15
9634,37,2011-08-22 20:00:07.343-04,8,7,15
9635,38,2011-08-22 20:00:07.343-04,33,2,35
9636,39,2011-08-22 20:00:07.343-04,12,7,19
9637,40,2011-08-22 20:00:07.343-04,12,1,13
9638,41,2011-08-22 20:00:07.343-04,18,1,19
9639,42,2011-08-22 20:00:07.343-04,2,17,19
9640,43,2011-08-22 20:00:07.343-04,3,12,15
9641,44,2011-08-22 20:00:07.343-04,15,4,19
9642,45,2011-08-22 20:00:07.343-04,8,11,19
9643,46,2011-08-22 20:00:07.343-04,11,8,19
9644,47,2011-08-22 20:00:07.343-04,11,0,11
9645,48,2011-08-22 20:00:07.343-04,0,15,15
9646,49,2011-08-22 20:00:07.343-04,11,4,15
9647,50,2011-08-22 20:00:07.343-04,0,15,15
9648,51,2011-08-22 20:00:07.343-04,6,9,15
9649,52,2011-08-22 20:00:07.343-04,9,5,14
9650,53,2011-08-22 20:00:07.343-04,14,1,15
9651,55,2011-08-22 20:00:07.343-04,7,8,15
9652,56,2011-08-22 20:00:07.343-04,6,9,15
9653,57,2011-08-22 20:00:07.343-04,4,7,11
9654,3,2011-08-22 20:00:07.343-04,9,8,17
9655,5,2011-08-22 20:00:07.343-04,6,9,15
9656,6,2011-08-22 20:00:07.343-04,13,2,15
9657,8,2011-08-22 20:00:07.343-04,5,10,15
9658,9,2011-08-22 20:00:07.343-04,9,10,19
9659,10,2011-08-22 20:00:07.343-04,3,16,19
9660,11,2011-08-22 20:00:07.343-04,6,9,15
9661,12,2011-08-22 20:00:07.343-04,12,3,15
9662,13,2011-08-22 20:00:07.343-04,7,8,15
9663,14,2011-08-22 20:00:07.343-04,4,13,17
9664,15,2011-08-22 20:00:07.343-04,4,11,15
9665,16,2011-08-22 20:00:07.343-04,8,11,19
9666,17,2011-08-22 20:00:07.343-04,3,12,15
9667,18,2011-08-22 20:00:07.343-04,9,6,15
9668,20,2011-08-22 20:00:07.343-04,16,3,19
9669,21,2011-08-22 20:00:07.343-04,6,17,23
9670,22,2011-08-22 20:00:07.343-04,19,28,47
9671,23,2011-08-22 20:00:07.343-04,1,17,18
9672,24,2011-08-22 20:00:07.343-04,1,14,15
9673,25,2011-08-22 20:00:07.343-04,9,6,15
9674,26,2011-08-22 20:00:07.343-04,8,7,15
9675,27,2011-08-22 20:00:07.343-04,6,8,14
9676,30,2011-08-22 20:00:07.343-04,11,4,15
9677,31,2011-08-22 20:00:07.343-04,4,7,11
9678,32,2011-08-22 20:00:07.343-04,9,2,11
9679,33,2011-08-22 20:00:07.343-04,8,11,19
9680,34,2011-08-22 20:00:07.343-04,8,7,15
9681,35,2011-08-22 20:00:07.343-04,2,9,11
9682,36,2011-08-22 20:00:07.343-04,0,15,15
9683,37,2011-08-22 20:00:07.343-04,8,7,15
9684,38,2011-08-22 20:00:07.343-04,33,2,35
9685,39,2011-08-22 20:00:07.343-04,12,7,19
9686,40,2011-08-22 20:00:07.343-04,12,1,13
9687,41,2011-08-22 20:00:07.343-04,18,1,19
9688,42,2011-08-22 20:00:07.343-04,2,17,19
9689,43,2011-08-22 20:00:07.343-04,3,12,15
9690,44,2011-08-22 20:00:07.343-04,15,4,19
9691,45,2011-08-22 20:00:07.343-04,8,11,19
9692,46,2011-08-22 20:00:07.343-04,11,8,19
9693,47,2011-08-22 20:00:07.343-04,11,0,11
9694,48,2011-08-22 20:00:07.343-04,0,15,15
9695,49,2011-08-22 20:00:07.343-04,11,4,15
9696,50,2011-08-22 20:00:07.343-04,0,15,15
9697,51,2011-08-22 20:00:07.343-04,6,9,15
9698,52,2011-08-22 20:00:07.343-04,9,5,14
9699,53,2011-08-22 20:00:07.343-04,14,1,15
9700,55,2011-08-22 20:00:07.343-04,7,8,15
9701,56,2011-08-22 20:00:07.343-04,6,9,15
9702,57,2011-08-22 20:00:07.343-04,4,7,11
9703,3,2011-08-22 20:01:08.185-04,9,8,17
9704,5,2011-08-22 20:01:08.185-04,6,9,15
9705,6,2011-08-22 20:01:08.185-04,13,2,15
9706,8,2011-08-22 20:01:08.185-04,7,8,15
9707,9,2011-08-22 20:01:08.185-04,9,10,19
9708,10,2011-08-22 20:01:08.185-04,3,16,19
9709,11,2011-08-22 20:01:08.185-04,7,8,15
9710,12,2011-08-22 20:01:08.185-04,12,3,15
9711,13,2011-08-22 20:01:08.185-04,7,8,15
9712,14,2011-08-22 20:01:08.185-04,4,13,17
9713,15,2011-08-22 20:01:08.185-04,4,11,15
9714,16,2011-08-22 20:01:08.185-04,8,11,19
9715,17,2011-08-22 20:01:08.185-04,3,12,15
9716,18,2011-08-22 20:01:08.185-04,9,6,15
9717,20,2011-08-22 20:01:08.185-04,16,3,19
9718,21,2011-08-22 20:01:08.185-04,6,17,23
9719,22,2011-08-22 20:01:08.185-04,19,28,47
9720,23,2011-08-22 20:01:08.185-04,1,17,18
9721,24,2011-08-22 20:01:08.185-04,1,14,15
9722,25,2011-08-22 20:01:08.185-04,9,6,15
9723,26,2011-08-22 20:01:08.185-04,8,7,15
9724,27,2011-08-22 20:01:08.185-04,6,8,14
9725,30,2011-08-22 20:01:08.185-04,11,4,15
9726,31,2011-08-22 20:01:08.185-04,4,7,11
9727,32,2011-08-22 20:01:08.185-04,10,1,11
9728,33,2011-08-22 20:01:08.185-04,6,13,19
9729,34,2011-08-22 20:01:08.185-04,8,7,15
9730,35,2011-08-22 20:01:08.185-04,2,9,11
9731,36,2011-08-22 20:01:08.185-04,0,15,15
9732,37,2011-08-22 20:01:08.185-04,8,7,15
9733,38,2011-08-22 20:01:08.185-04,33,2,35
9734,39,2011-08-22 20:01:08.185-04,12,7,19
9735,40,2011-08-22 20:01:08.185-04,12,1,13
9736,41,2011-08-22 20:01:08.185-04,18,1,19
9737,42,2011-08-22 20:01:08.185-04,2,17,19
9738,43,2011-08-22 20:01:08.185-04,3,12,15
9739,44,2011-08-22 20:01:08.185-04,15,4,19
9740,45,2011-08-22 20:01:08.185-04,8,11,19
9741,46,2011-08-22 20:01:08.185-04,11,8,19
9742,47,2011-08-22 20:01:08.185-04,11,0,11
9743,48,2011-08-22 20:01:08.185-04,0,15,15
9744,49,2011-08-22 20:01:08.185-04,11,4,15
9745,50,2011-08-22 20:01:08.185-04,0,15,15
9746,51,2011-08-22 20:01:08.185-04,6,9,15
9747,52,2011-08-22 20:01:08.185-04,7,7,14
9748,53,2011-08-22 20:01:08.185-04,14,1,15
9749,55,2011-08-22 20:01:08.185-04,7,8,15
9750,56,2011-08-22 20:01:08.185-04,6,9,15
9751,57,2011-08-22 20:01:08.185-04,4,7,11
9752,3,2011-08-22 20:02:09.064-04,9,8,17
9753,5,2011-08-22 20:02:09.064-04,6,9,15
9754,6,2011-08-22 20:02:09.064-04,13,2,15
9755,8,2011-08-22 20:02:09.064-04,7,8,15
9756,9,2011-08-22 20:02:09.064-04,9,10,19
9757,10,2011-08-22 20:02:09.064-04,3,16,19
9758,11,2011-08-22 20:02:09.064-04,8,7,15
9759,12,2011-08-22 20:02:09.064-04,12,3,15
9760,13,2011-08-22 20:02:09.064-04,8,7,15
9761,14,2011-08-22 20:02:09.064-04,4,13,17
9762,15,2011-08-22 20:02:09.064-04,4,11,15
9763,16,2011-08-22 20:02:09.064-04,8,11,19
9764,17,2011-08-22 20:02:09.064-04,3,12,15
9765,18,2011-08-22 20:02:09.064-04,9,6,15
9766,20,2011-08-22 20:02:09.064-04,16,3,19
9767,21,2011-08-22 20:02:09.064-04,6,17,23
9768,22,2011-08-22 20:02:09.064-04,20,27,47
9769,23,2011-08-22 20:02:09.064-04,1,17,18
9770,24,2011-08-22 20:02:09.064-04,1,14,15
9771,25,2011-08-22 20:02:09.064-04,8,7,15
9772,26,2011-08-22 20:02:09.064-04,8,7,15
9773,27,2011-08-22 20:02:09.064-04,6,8,14
9774,30,2011-08-22 20:02:09.064-04,11,4,15
9775,31,2011-08-22 20:02:09.064-04,4,7,11
9776,32,2011-08-22 20:02:09.064-04,10,1,11
9777,33,2011-08-22 20:02:09.064-04,5,14,19
9778,34,2011-08-22 20:02:09.064-04,8,7,15
9779,35,2011-08-22 20:02:09.064-04,2,9,11
9780,36,2011-08-22 20:02:09.064-04,0,15,15
9781,37,2011-08-22 20:02:09.064-04,8,7,15
9782,38,2011-08-22 20:02:09.064-04,33,2,35
9783,39,2011-08-22 20:02:09.064-04,13,6,19
9784,40,2011-08-22 20:02:09.064-04,12,1,13
9785,41,2011-08-22 20:02:09.064-04,18,1,19
9786,42,2011-08-22 20:02:09.064-04,2,17,19
9787,43,2011-08-22 20:02:09.064-04,3,12,15
9788,44,2011-08-22 20:02:09.064-04,15,4,19
9789,45,2011-08-22 20:02:09.064-04,8,11,19
9790,46,2011-08-22 20:02:09.064-04,11,8,19
9791,47,2011-08-22 20:02:09.064-04,11,0,11
9792,48,2011-08-22 20:02:09.064-04,0,15,15
9793,49,2011-08-22 20:02:09.064-04,10,5,15
9794,50,2011-08-22 20:02:09.064-04,0,15,15
9795,51,2011-08-22 20:02:09.064-04,6,9,15
9796,52,2011-08-22 20:02:09.064-04,7,7,14
9797,53,2011-08-22 20:02:09.064-04,15,0,15
9798,55,2011-08-22 20:02:09.064-04,7,8,15
9799,56,2011-08-22 20:02:09.064-04,6,9,15
9800,57,2011-08-22 20:02:09.064-04,4,7,11
9801,3,2011-08-22 20:03:10.122-04,9,8,17
9802,5,2011-08-22 20:03:10.122-04,6,9,15
9803,6,2011-08-22 20:03:10.122-04,13,2,15
9804,8,2011-08-22 20:03:10.122-04,7,8,15
9805,9,2011-08-22 20:03:10.122-04,9,10,19
9806,10,2011-08-22 20:03:10.122-04,3,16,19
9807,11,2011-08-22 20:03:10.122-04,8,7,15
9808,12,2011-08-22 20:03:10.122-04,12,3,15
9809,13,2011-08-22 20:03:10.122-04,8,7,15
9810,14,2011-08-22 20:03:10.122-04,4,13,17
9811,15,2011-08-22 20:03:10.122-04,4,11,15
9812,16,2011-08-22 20:03:10.122-04,8,11,19
9813,17,2011-08-22 20:03:10.122-04,3,12,15
9814,18,2011-08-22 20:03:10.122-04,9,6,15
9815,20,2011-08-22 20:03:10.122-04,16,3,19
9816,21,2011-08-22 20:03:10.122-04,6,17,23
9817,22,2011-08-22 20:03:10.122-04,19,28,47
9818,23,2011-08-22 20:03:10.122-04,1,17,18
9819,24,2011-08-22 20:03:10.122-04,1,14,15
9820,25,2011-08-22 20:03:10.122-04,7,8,15
9821,26,2011-08-22 20:03:10.122-04,8,7,15
9822,27,2011-08-22 20:03:10.122-04,6,8,14
9823,30,2011-08-22 20:03:10.122-04,11,4,15
9824,31,2011-08-22 20:03:10.122-04,4,7,11
9825,32,2011-08-22 20:03:10.122-04,10,1,11
9826,33,2011-08-22 20:03:10.122-04,5,14,19
9827,34,2011-08-22 20:03:10.122-04,8,7,15
9828,35,2011-08-22 20:03:10.122-04,2,9,11
9829,36,2011-08-22 20:03:10.122-04,0,15,15
9830,37,2011-08-22 20:03:10.122-04,8,7,15
9831,38,2011-08-22 20:03:10.122-04,32,3,35
9832,39,2011-08-22 20:03:10.122-04,13,6,19
9833,40,2011-08-22 20:03:10.122-04,12,1,13
9834,41,2011-08-22 20:03:10.122-04,18,1,19
9835,42,2011-08-22 20:03:10.122-04,2,17,19
9836,43,2011-08-22 20:03:10.122-04,3,12,15
9837,44,2011-08-22 20:03:10.122-04,15,4,19
9838,45,2011-08-22 20:03:10.122-04,8,11,19
9839,46,2011-08-22 20:03:10.122-04,11,8,19
9840,47,2011-08-22 20:03:10.122-04,11,0,11
9841,48,2011-08-22 20:03:10.122-04,0,15,15
9842,49,2011-08-22 20:03:10.122-04,10,5,15
9843,50,2011-08-22 20:03:10.122-04,0,15,15
9844,51,2011-08-22 20:03:10.122-04,6,9,15
9845,52,2011-08-22 20:03:10.122-04,9,5,14
9846,53,2011-08-22 20:03:10.122-04,15,0,15
9847,55,2011-08-22 20:03:10.122-04,7,8,15
9848,56,2011-08-22 20:03:10.122-04,6,9,15
9849,57,2011-08-22 20:03:10.122-04,4,7,11
9850,3,2011-08-22 20:04:11.18-04,9,8,17
9851,5,2011-08-22 20:04:11.18-04,6,9,15
9852,6,2011-08-22 20:04:11.18-04,13,2,15
9853,8,2011-08-22 20:04:11.18-04,5,10,15
9854,9,2011-08-22 20:04:11.18-04,9,10,19
9855,10,2011-08-22 20:04:11.18-04,3,16,19
9856,11,2011-08-22 20:04:11.18-04,8,7,15
9857,12,2011-08-22 20:04:11.18-04,12,3,15
9858,13,2011-08-22 20:04:11.18-04,8,7,15
9859,14,2011-08-22 20:04:11.18-04,4,13,17
9860,15,2011-08-22 20:04:11.18-04,4,11,15
9861,16,2011-08-22 20:04:11.18-04,8,11,19
9862,17,2011-08-22 20:04:11.18-04,3,12,15
9863,18,2011-08-22 20:04:11.18-04,9,6,15
9864,20,2011-08-22 20:04:11.18-04,16,3,19
9865,21,2011-08-22 20:04:11.18-04,6,17,23
9866,22,2011-08-22 20:04:11.18-04,19,28,47
9867,23,2011-08-22 20:04:11.18-04,1,17,18
9868,24,2011-08-22 20:04:11.18-04,1,14,15
9869,25,2011-08-22 20:04:11.18-04,7,8,15
9870,26,2011-08-22 20:04:11.18-04,8,7,15
9871,27,2011-08-22 20:04:11.18-04,6,8,14
9872,30,2011-08-22 20:04:11.18-04,11,4,15
9873,31,2011-08-22 20:04:11.18-04,4,7,11
9874,32,2011-08-22 20:04:11.18-04,10,1,11
9875,33,2011-08-22 20:04:11.18-04,5,14,19
9876,34,2011-08-22 20:04:11.18-04,8,7,15
9877,35,2011-08-22 20:04:11.18-04,2,9,11
9878,36,2011-08-22 20:04:11.18-04,0,15,15
9879,37,2011-08-22 20:04:11.18-04,8,7,15
9880,38,2011-08-22 20:04:11.18-04,32,3,35
9881,39,2011-08-22 20:04:11.18-04,13,6,19
9882,40,2011-08-22 20:04:11.18-04,12,1,13
9883,41,2011-08-22 20:04:11.18-04,18,1,19
9884,42,2011-08-22 20:04:11.18-04,2,17,19
9885,43,2011-08-22 20:04:11.18-04,3,12,15
9886,44,2011-08-22 20:04:11.18-04,15,4,19
9887,45,2011-08-22 20:04:11.18-04,8,11,19
9888,46,2011-08-22 20:04:11.18-04,11,8,19
9889,47,2011-08-22 20:04:11.18-04,11,0,11
9890,48,2011-08-22 20:04:11.18-04,0,15,15
9891,49,2011-08-22 20:04:11.18-04,10,5,15
9892,50,2011-08-22 20:04:11.18-04,0,15,15
9893,51,2011-08-22 20:04:11.18-04,6,9,15
9894,52,2011-08-22 20:04:11.18-04,9,5,14
9895,53,2011-08-22 20:04:11.18-04,15,0,15
9896,55,2011-08-22 20:04:11.18-04,7,8,15
9897,56,2011-08-22 20:04:11.18-04,6,9,15
9898,57,2011-08-22 20:04:11.18-04,4,7,11
9899,3,2011-08-22 20:05:12.097-04,9,8,17
9900,5,2011-08-22 20:05:12.097-04,6,9,15
9901,6,2011-08-22 20:05:12.097-04,13,2,15
9902,8,2011-08-22 20:05:12.097-04,5,10,15
9903,9,2011-08-22 20:05:12.097-04,9,10,19
9904,10,2011-08-22 20:05:12.097-04,3,16,19
9905,11,2011-08-22 20:05:12.097-04,8,7,15
9906,12,2011-08-22 20:05:12.097-04,12,3,15
9907,13,2011-08-22 20:05:12.097-04,8,7,15
9908,14,2011-08-22 20:05:12.097-04,5,12,17
9909,15,2011-08-22 20:05:12.097-04,4,11,15
9910,16,2011-08-22 20:05:12.097-04,8,11,19
9911,17,2011-08-22 20:05:12.097-04,3,12,15
9912,18,2011-08-22 20:05:12.097-04,9,6,15
9913,20,2011-08-22 20:05:12.097-04,16,3,19
9914,21,2011-08-22 20:05:12.097-04,6,17,23
9915,22,2011-08-22 20:05:12.097-04,19,28,47
9916,23,2011-08-22 20:05:12.097-04,1,17,18
9917,24,2011-08-22 20:05:12.097-04,1,14,15
9918,25,2011-08-22 20:05:12.097-04,7,8,15
9919,26,2011-08-22 20:05:12.097-04,8,7,15
9920,27,2011-08-22 20:05:12.097-04,6,8,14
9921,30,2011-08-22 20:05:12.097-04,11,4,15
9922,31,2011-08-22 20:05:12.097-04,4,7,11
9923,32,2011-08-22 20:05:12.097-04,10,1,11
9924,33,2011-08-22 20:05:12.097-04,5,14,19
9925,34,2011-08-22 20:05:12.097-04,8,7,15
9926,35,2011-08-22 20:05:12.097-04,1,10,11
9927,36,2011-08-22 20:05:12.097-04,0,15,15
9928,37,2011-08-22 20:05:12.097-04,8,7,15
9929,38,2011-08-22 20:05:12.097-04,32,3,35
9930,39,2011-08-22 20:05:12.097-04,14,5,19
9931,40,2011-08-22 20:05:12.097-04,12,1,13
9932,41,2011-08-22 20:05:12.097-04,18,1,19
9933,42,2011-08-22 20:05:12.097-04,3,16,19
9934,43,2011-08-22 20:05:12.097-04,3,12,15
9935,44,2011-08-22 20:05:12.097-04,15,4,19
9936,45,2011-08-22 20:05:12.097-04,8,11,19
9937,46,2011-08-22 20:05:12.097-04,11,8,19
9938,47,2011-08-22 20:05:12.097-04,11,0,11
9939,48,2011-08-22 20:05:12.097-04,0,15,15
9940,49,2011-08-22 20:05:12.097-04,10,5,15
9941,50,2011-08-22 20:05:12.097-04,0,15,15
9942,51,2011-08-22 20:05:12.097-04,6,9,15
9943,52,2011-08-22 20:05:12.097-04,8,6,14
9944,53,2011-08-22 20:05:12.097-04,15,0,15
9945,55,2011-08-22 20:05:12.097-04,7,8,15
9946,56,2011-08-22 20:05:12.097-04,6,9,15
9947,57,2011-08-22 20:05:12.097-04,4,7,11
9948,3,2011-08-22 20:06:13.016-04,9,8,17
9949,5,2011-08-22 20:06:13.016-04,6,9,15
9950,6,2011-08-22 20:06:13.016-04,13,2,15
9951,8,2011-08-22 20:06:13.016-04,5,10,15
9952,9,2011-08-22 20:06:13.016-04,9,10,19
9953,10,2011-08-22 20:06:13.016-04,3,16,19
9954,11,2011-08-22 20:06:13.016-04,8,7,15
9955,12,2011-08-22 20:06:13.016-04,12,3,15
9956,13,2011-08-22 20:06:13.016-04,8,7,15
9957,14,2011-08-22 20:06:13.016-04,5,12,17
9958,15,2011-08-22 20:06:13.016-04,4,11,15
9959,16,2011-08-22 20:06:13.016-04,8,11,19
9960,17,2011-08-22 20:06:13.016-04,3,12,15
9961,18,2011-08-22 20:06:13.016-04,9,6,15
9962,20,2011-08-22 20:06:13.016-04,16,3,19
9963,21,2011-08-22 20:06:13.016-04,6,17,23
9964,22,2011-08-22 20:06:13.016-04,19,28,47
9965,23,2011-08-22 20:06:13.016-04,1,17,18
9966,24,2011-08-22 20:06:13.016-04,1,14,15
9967,25,2011-08-22 20:06:13.016-04,7,8,15
9968,26,2011-08-22 20:06:13.016-04,8,7,15
9969,27,2011-08-22 20:06:13.016-04,6,8,14
9970,30,2011-08-22 20:06:13.016-04,11,4,15
9971,31,2011-08-22 20:06:13.016-04,4,7,11
9972,32,2011-08-22 20:06:13.016-04,10,1,11
9973,33,2011-08-22 20:06:13.016-04,5,14,19
9974,34,2011-08-22 20:06:13.016-04,8,7,15
9975,35,2011-08-22 20:06:13.016-04,1,10,11
9976,36,2011-08-22 20:06:13.016-04,0,15,15
9977,37,2011-08-22 20:06:13.016-04,8,7,15
9978,38,2011-08-22 20:06:13.016-04,32,3,35
9979,39,2011-08-22 20:06:13.016-04,14,5,19
9980,40,2011-08-22 20:06:13.016-04,12,1,13
9981,41,2011-08-22 20:06:13.016-04,18,1,19
9982,42,2011-08-22 20:06:13.016-04,2,17,19
9983,43,2011-08-22 20:06:13.016-04,3,12,15
9984,44,2011-08-22 20:06:13.016-04,15,4,19
9985,45,2011-08-22 20:06:13.016-04,8,11,19
9986,46,2011-08-22 20:06:13.016-04,11,8,19
9987,47,2011-08-22 20:06:13.016-04,11,0,11
9988,48,2011-08-22 20:06:13.016-04,0,15,15
9989,49,2011-08-22 20:06:13.016-04,10,5,15
9990,50,2011-08-22 20:06:13.016-04,0,15,15
9991,51,2011-08-22 20:06:13.016-04,6,9,15
9992,52,2011-08-22 20:06:13.016-04,7,7,14
9993,53,2011-08-22 20:06:13.016-04,15,0,15
9994,55,2011-08-22 20:06:13.016-04,7,8,15
9995,56,2011-08-22 20:06:13.016-04,6,9,15
9996,57,2011-08-22 20:06:13.016-04,4,7,11
9997,3,2011-08-22 20:07:13.863-04,9,8,17
9998,5,2011-08-22 20:07:13.863-04,6,9,15
9999,6,2011-08-22 20:07:13.863-04,13,2,15
